census_year,tract,housing_units_total,housing_units_rental,housing_units_other,median_rent,population_total,population_poverty_below,population_poverty_above,population_race_white,population_race_black,population_race_latinx,population_race_asian,population_race_other
2006-2010 5-year estimates,17031980100,0,0,0,0,0,0,0,0,0,0,0,0
2014-2018 5-year estimates,17031980100,0,0,0,0,0,0,0,0,0,0,0,0
2006-2010 5-year estimates,17031980000,0,0,0,0,0,0,0,0,0,0,0,0
2014-2018 5-year estimates,17031980000,0,0,0,0,0,0,0,0,0,0,0,0
2006-2010 5-year estimates,17031843900,2298,1274,1024,828,3360,511,2849,85,3007,137,57,74
2014-2018 5-year estimates,17031843900,2329,1614,715,1027,3521,1000,2521,159,3079,109,101,73
2006-2010 5-year estimates,17031843800,833,397,436,1075,2107,512,1595,571,1234,147,136,19
2014-2018 5-year estimates,17031843800,839,368,471,1144,1482,341,1141,354,839,183,100,6
2006-2010 5-year estimates,17031843700,978,389,589,1070,1979,202,1777,1352,90,376,81,80
2014-2018 5-year estimates,17031843700,1016,352,664,1331,2617,97,2520,1512,61,709,190,145
2006-2010 5-year estimates,17031843600,1507,968,539,917,2970,751,2219,59,2874,0,0,37
2014-2018 5-year estimates,17031843600,1554,1123,431,1093,2918,657,2261,73,2592,130,26,97
2006-2010 5-year estimates,17031843500,332,144,188,595,12219,5731,6488,1357,8379,2448,28,7
2014-2018 5-year estimates,17031843500,329,194,135,794,10317,3539,6778,902,6767,2617,31,0
2006-2010 5-year estimates,17031843400,643,332,311,905,1536,441,1095,0,1370,166,0,0
2014-2018 5-year estimates,17031843400,621,329,292,639,1195,372,823,39,854,302,0,0
2006-2010 5-year estimates,17031843300,517,314,203,984,1439,635,804,122,797,520,0,0
2014-2018 5-year estimates,17031843300,539,364,175,973,1972,883,1089,181,1197,579,12,3
2006-2010 5-year estimates,17031843200,1058,673,385,862,2780,614,2166,382,102,2234,62,0
2014-2018 5-year estimates,17031843200,1051,661,390,881,2357,575,1782,580,76,1664,24,13
2006-2010 5-year estimates,17031843100,791,539,252,870,2466,602,1864,103,2287,57,9,10
2014-2018 5-year estimates,17031843100,715,447,268,916,1692,816,876,167,1435,59,0,31
2006-2010 5-year estimates,17031843000,1215,896,319,898,2998,1499,1499,0,2986,12,0,0
2014-2018 5-year estimates,17031843000,1227,909,318,888,2533,1077,1456,0,2427,69,0,37
2006-2010 5-year estimates,17031842900,1283,1014,269,397,2477,1486,991,110,2235,96,28,8
2014-2018 5-year estimates,17031842900,1215,1023,192,561,2479,1081,1398,257,1887,154,87,94
2006-2010 5-year estimates,17031842800,2197,1249,948,803,7542,2217,5325,767,0,6730,23,22
2014-2018 5-year estimates,17031842800,2347,1213,1134,928,7035,2779,4256,226,84,6322,336,67
2006-2010 5-year estimates,17031842600,1660,665,995,883,4365,952,3413,2759,10,1038,449,109
2014-2018 5-year estimates,17031842600,1670,690,980,974,4125,487,3638,2160,203,1327,355,80
2006-2010 5-year estimates,17031842500,985,796,189,407,2603,1567,1036,0,2505,49,0,49
2014-2018 5-year estimates,17031842500,922,752,170,392,1973,1251,722,2,1970,1,0,0
2006-2010 5-year estimates,17031842400,1521,651,870,784,3766,1062,2704,8,3721,15,22,0
2014-2018 5-year estimates,17031842400,1475,470,1005,1031,3115,854,2261,17,3011,11,76,0
2006-2010 5-year estimates,17031842300,1633,658,975,1077,2850,185,2665,1773,708,83,240,46
2014-2018 5-year estimates,17031842300,1636,679,957,1743,3358,188,3170,2333,353,331,193,148
2006-2010 5-year estimates,17031842200,1472,826,646,772,2662,985,1677,798,1546,102,105,111
2014-2018 5-year estimates,17031842200,2076,1374,702,1996,3154,284,2870,2150,379,368,199,58
2006-2010 5-year estimates,17031842100,2334,1146,1188,893,5824,2248,3576,143,3412,2184,51,34
2014-2018 5-year estimates,17031842100,2313,1092,1221,941,7489,2037,5452,285,3228,3853,63,60
2006-2010 5-year estimates,17031842000,583,195,388,890,3438,1055,2383,1348,1442,79,553,16
2014-2018 5-year estimates,17031842000,398,92,306,2114,3134,652,2482,1184,945,258,673,74
2006-2010 5-year estimates,17031841900,1740,501,1239,1624,5077,1371,3706,2050,1637,397,747,246
2014-2018 5-year estimates,17031841900,1736,709,1027,1956,6540,1190,5350,3174,1132,735,1295,204
2006-2010 5-year estimates,17031841800,1230,568,662,933,3186,1456,1730,56,2961,63,0,106
2014-2018 5-year estimates,17031841800,1193,588,605,898,2435,643,1792,15,2321,66,0,33
2006-2010 5-year estimates,17031841700,799,572,227,322,1154,372,782,9,692,436,0,17
2014-2018 5-year estimates,17031841700,896,606,290,682,1825,719,1106,93,801,872,0,59
2006-2010 5-year estimates,17031841600,380,210,170,1141,1051,507,544,33,1018,0,0,0
2014-2018 5-year estimates,17031841600,365,202,163,1222,655,343,312,4,564,87,0,0
2006-2010 5-year estimates,17031841500,1221,698,523,839,2342,1009,1333,0,2326,0,0,16
2014-2018 5-year estimates,17031841500,1208,810,398,1030,2847,1022,1825,31,2696,78,21,21
2006-2010 5-year estimates,17031841400,618,406,212,913,1326,732,594,71,1206,49,0,0
2014-2018 5-year estimates,17031841400,554,272,282,1145,1135,361,774,28,950,155,2,0
2006-2010 5-year estimates,17031841300,1929,1087,842,734,5097,1315,3782,639,70,4300,0,88
2014-2018 5-year estimates,17031841300,1703,905,798,906,3960,836,3124,702,212,2918,61,67
2006-2010 5-year estimates,17031841200,1969,1175,794,687,4946,1568,3378,522,86,4284,0,54
2014-2018 5-year estimates,17031841200,1940,1347,593,924,4839,924,3915,802,276,3605,144,12
2006-2010 5-year estimates,17031841100,2779,1395,1384,644,6970,2070,4900,705,247,37,5926,55
2014-2018 5-year estimates,17031841100,2910,1547,1363,800,7072,2206,4866,348,260,179,6269,16
2006-2010 5-year estimates,17031841000,843,303,540,329,937,497,440,74,807,0,43,13
2014-2018 5-year estimates,17031841000,613,295,318,2037,979,171,808,285,396,36,210,52
2006-2010 5-year estimates,17031840800,990,625,365,801,3386,1155,2231,161,10,3215,0,0
2014-2018 5-year estimates,17031840800,966,619,347,805,3011,1204,1807,14,27,2970,0,0
2006-2010 5-year estimates,17031840700,1243,722,521,741,2914,1029,1885,166,0,2748,0,0
2014-2018 5-year estimates,17031840700,1283,745,538,819,3697,1275,2422,323,183,3149,0,42
2006-2010 5-year estimates,17031840400,1228,412,816,983,3251,770,2481,872,34,1333,1012,0
2014-2018 5-year estimates,17031840400,1198,417,781,838,3135,683,2452,527,2,1287,1306,13
2006-2010 5-year estimates,17031840300,1265,517,748,794,4085,825,3260,387,0,3057,595,46
2014-2018 5-year estimates,17031840300,1295,403,892,930,3872,848,3024,689,70,1978,1135,0
2006-2010 5-year estimates,17031840200,888,234,654,1001,2084,275,1809,520,12,303,1171,78
2014-2018 5-year estimates,17031840200,885,348,537,1026,2488,323,2165,533,48,407,1453,47
2006-2010 5-year estimates,17031840100,1175,685,490,745,2716,619,2097,513,0,382,1778,43
2014-2018 5-year estimates,17031840100,1133,677,456,890,3176,489,2687,646,37,446,1955,92
2006-2010 5-year estimates,17031840000,1097,416,681,924,2631,292,2339,1335,0,184,1112,0
2014-2018 5-year estimates,17031840000,1057,413,644,945,2881,400,2481,1145,10,584,1120,22
2006-2010 5-year estimates,17031839900,1816,758,1058,765,3529,356,3173,1880,16,1162,432,39
2014-2018 5-year estimates,17031839900,2000,891,1109,988,4419,654,3765,2123,188,1137,910,61
2006-2010 5-year estimates,17031839800,1254,768,486,810,3016,383,2633,1169,0,1025,798,24
2014-2018 5-year estimates,17031839800,1275,771,504,980,2831,495,2336,1183,50,588,958,52
2006-2010 5-year estimates,17031839700,2000,896,1104,802,4989,1277,3712,2003,74,1731,1170,11
2014-2018 5-year estimates,17031839700,1994,1029,965,901,4510,929,3581,1674,72,1591,1092,81
2006-2010 5-year estimates,17031839600,965,531,434,691,1903,186,1717,55,1803,45,0,0
2014-2018 5-year estimates,17031839600,918,489,429,1026,1367,182,1185,52,1217,78,5,15
2006-2010 5-year estimates,17031839500,1019,625,394,269,1658,388,1270,227,1391,8,32,0
2014-2018 5-year estimates,17031839500,910,463,447,289,1510,491,1019,262,1025,47,127,49
2006-2010 5-year estimates,17031839200,1783,974,809,776,2438,383,2055,350,1935,50,83,20
2014-2018 5-year estimates,17031839200,1685,994,691,861,2452,559,1893,279,1508,136,389,140
2006-2010 5-year estimates,17031839100,1976,1085,891,1419,2962,459,2503,1859,418,211,413,61
2014-2018 5-year estimates,17031839100,4438,2788,1650,1949,7352,838,6514,3997,767,752,1690,146
2006-2010 5-year estimates,17031839000,3455,1340,2115,1406,5499,764,4735,3687,829,222,602,159
2014-2018 5-year estimates,17031839000,5645,3257,2388,2074,8789,1468,7321,5428,1128,706,1167,360
2006-2010 5-year estimates,17031838800,1311,566,745,612,3239,1160,2079,107,1387,1745,0,0
2014-2018 5-year estimates,17031838800,1294,683,611,400,3173,1349,1824,188,1585,1388,0,12
2006-2010 5-year estimates,17031838700,1919,1105,814,935,3742,1602,2140,0,3665,77,0,0
2014-2018 5-year estimates,17031838700,1909,1446,463,987,4311,1944,2367,44,4084,183,0,0
2006-2010 5-year estimates,17031838600,617,427,190,640,1612,883,729,9,1553,50,0,0
2014-2018 5-year estimates,17031838600,639,559,80,743,1507,772,735,31,1364,109,0,3
2006-2010 5-year estimates,17031838300,736,520,216,1027,1300,499,801,320,518,391,71,0
2014-2018 5-year estimates,17031838300,736,542,194,1243,1425,274,1151,500,533,57,276,59
2006-2010 5-year estimates,17031838200,473,236,237,925,1495,335,1160,406,355,126,436,172
2014-2018 5-year estimates,17031838200,419,267,152,1066,1976,682,1294,799,506,290,315,66
2006-2010 5-year estimates,17031838100,1470,1129,341,771,1866,494,1372,462,779,144,420,61
2014-2018 5-year estimates,17031838100,1346,1097,249,484,1760,649,1111,501,814,205,222,18
2006-2010 5-year estimates,17031838000,1428,928,500,460,2664,1244,1420,303,2000,164,119,78
2014-2018 5-year estimates,17031838000,1354,1021,333,515,2577,938,1639,298,1753,369,86,71
2006-2010 5-year estimates,17031837800,1104,734,370,794,2654,605,2049,258,2192,85,62,57
2014-2018 5-year estimates,17031837800,1195,886,309,1227,2662,855,1807,491,1884,126,123,38
2006-2010 5-year estimates,17031837400,896,469,427,813,1827,800,1027,87,1690,16,25,9
2014-2018 5-year estimates,17031837400,858,616,242,953,2460,1065,1395,165,2231,21,7,36
2006-2010 5-year estimates,17031837300,858,411,447,1119,2257,853,1404,137,1991,83,24,22
2014-2018 5-year estimates,17031837300,897,499,398,1049,2607,871,1736,120,2306,110,44,27
2006-2010 5-year estimates,17031837100,1042,444,598,595,2052,644,1408,195,1501,202,48,106
2014-2018 5-year estimates,17031837100,872,487,385,916,1596,386,1210,289,1041,182,24,60
2006-2010 5-year estimates,17031837000,1058,716,342,858,2229,1043,1186,36,2131,32,22,8
2014-2018 5-year estimates,17031837000,919,575,344,718,1950,934,1016,163,1608,97,0,82
2006-2010 5-year estimates,17031836900,639,361,278,1004,1583,738,845,38,1498,12,0,35
2014-2018 5-year estimates,17031836900,586,402,184,827,1251,509,742,94,1042,96,11,8
2006-2010 5-year estimates,17031836800,1102,699,403,751,2644,1327,1317,121,2472,23,9,19
2014-2018 5-year estimates,17031836800,1131,789,342,735,2164,1482,682,143,1977,44,0,0
2006-2010 5-year estimates,17031836700,962,665,297,861,2695,1261,1434,65,2239,362,29,0
2014-2018 5-year estimates,17031836700,1020,631,389,950,2422,940,1482,126,1574,710,6,6
2006-2010 5-year estimates,17031836600,1137,721,416,879,3053,1392,1661,135,1097,1811,0,10
2014-2018 5-year estimates,17031836600,1142,680,462,1036,2291,406,1885,375,682,1212,13,9
2006-2010 5-year estimates,17031836500,632,531,101,831,1661,502,1159,106,1542,0,0,13
2014-2018 5-year estimates,17031836500,738,674,64,925,1610,398,1212,0,1596,0,0,14
2006-2010 5-year estimates,17031836400,1670,1169,501,582,3223,986,2237,82,2974,104,51,12
2014-2018 5-year estimates,17031836400,1851,1287,564,486,3737,1110,2627,145,3233,232,97,30
2006-2010 5-year estimates,17031836300,794,295,499,758,1176,390,786,223,765,47,94,47
2014-2018 5-year estimates,17031836300,738,510,228,1028,1488,385,1103,614,684,39,47,104
2006-2010 5-year estimates,17031836200,281,94,187,1236,1256,497,759,1049,13,82,98,14
2014-2018 5-year estimates,17031836200,138,52,86,1273,1604,338,1266,1037,126,127,292,22
2006-2010 5-year estimates,17031836100,945,506,439,727,1849,664,1185,0,1801,48,0,0
2014-2018 5-year estimates,17031836100,940,738,202,738,2039,838,1201,52,1721,102,8,156
2006-2010 5-year estimates,17031836000,1215,500,715,1028,2225,572,1653,31,2092,40,0,62
2014-2018 5-year estimates,17031836000,1116,541,575,1095,2785,819,1966,43,2689,28,0,25
2006-2010 5-year estimates,17031835900,1596,965,631,569,3110,1232,1878,55,2920,128,0,7
2014-2018 5-year estimates,17031835900,1709,1289,420,715,3190,1372,1818,78,3011,71,19,11
2006-2010 5-year estimates,17031835800,828,273,555,788,1389,481,908,11,1378,0,0,0
2014-2018 5-year estimates,17031835800,747,452,295,990,1858,792,1066,50,1721,32,0,55
2006-2010 5-year estimates,17031835700,0,0,0,0,0,0,0,0,0,0,0,0
2014-2018 5-year estimates,17031835700,154,154,0,848,416,46,370,0,416,0,0,0
2006-2010 5-year estimates,17031835600,601,255,346,1020,1174,464,710,17,1150,7,0,0
2014-2018 5-year estimates,17031835600,535,320,215,614,841,98,743,0,750,91,0,0
2006-2010 5-year estimates,17031835500,1006,642,364,500,1886,962,924,44,1750,48,9,35
2014-2018 5-year estimates,17031835500,967,534,433,442,1479,563,916,45,1383,51,0,0
2006-2010 5-year estimates,17031835200,659,168,491,832,1697,64,1633,919,45,657,76,0
2014-2018 5-year estimates,17031835200,731,251,480,786,2020,194,1826,583,0,1358,79,0
2006-2010 5-year estimates,17031835100,1422,612,810,857,5629,664,4965,162,1054,4270,27,116
2014-2018 5-year estimates,17031835100,1524,618,906,959,5505,1167,4338,97,853,4500,36,19
2006-2010 5-year estimates,17031835000,2328,1370,958,787,5996,2260,3736,166,4088,1672,70,0
2014-2018 5-year estimates,17031835000,2296,1323,973,828,5622,1844,3778,71,3092,2458,1,0
2006-2010 5-year estimates,17031834900,1080,703,377,589,2444,1202,1242,0,2437,0,0,7
2014-2018 5-year estimates,17031834900,995,593,402,796,1615,812,803,16,1562,4,0,33
2006-2010 5-year estimates,17031834800,1186,589,597,754,2194,928,1266,0,2194,0,0,0
2014-2018 5-year estimates,17031834800,1022,581,441,731,1546,674,872,0,1462,83,1,0
2006-2010 5-year estimates,17031834700,1041,473,568,1071,2477,671,1806,0,2466,11,0,0
2014-2018 5-year estimates,17031834700,1032,597,435,880,1426,746,680,1,1262,111,42,10
2006-2010 5-year estimates,17031834600,1823,937,886,898,4012,1898,2114,43,3960,0,0,9
2014-2018 5-year estimates,17031834600,1377,730,647,792,1975,794,1181,36,1715,224,0,0
2006-2010 5-year estimates,17031834500,698,379,319,930,1495,565,930,0,1417,71,0,7
2014-2018 5-year estimates,17031834500,677,505,172,1014,1376,488,888,0,1267,0,0,109
2006-2010 5-year estimates,17031834400,1970,899,1071,845,3008,463,2545,129,2637,123,19,100
2014-2018 5-year estimates,17031834400,1957,1129,828,1188,4390,1133,3257,114,4121,65,15,75
2006-2010 5-year estimates,17031834300,2832,921,1911,1043,6404,1294,5110,17,6321,0,16,50
2014-2018 5-year estimates,17031834300,2893,993,1900,776,6004,1093,4911,46,5761,55,80,62
2006-2010 5-year estimates,17031834200,2601,1611,990,879,4832,894,3938,42,4679,32,51,28
2014-2018 5-year estimates,17031834200,2421,1075,1346,971,4249,765,3484,16,4146,49,0,38
2006-2010 5-year estimates,17031834000,1549,1066,483,871,3572,729,2843,11,3390,52,0,119
2014-2018 5-year estimates,17031834000,1488,1154,334,1093,2926,857,2069,9,2855,0,31,31
2006-2010 5-year estimates,17031833900,1195,584,611,694,2285,985,1300,81,707,1497,0,0
2014-2018 5-year estimates,17031833900,1079,578,501,795,2530,858,1672,2,1212,1280,30,6
2006-2010 5-year estimates,17031833300,1020,655,365,1144,1923,675,1248,1015,33,287,588,0
2014-2018 5-year estimates,17031833300,1108,690,418,1526,2699,1163,1536,1134,157,257,1081,70
2006-2010 5-year estimates,17031833100,3555,1067,2488,1350,6057,866,5191,4236,890,217,670,44
2014-2018 5-year estimates,17031833100,3910,1580,2330,1995,7250,841,6409,4395,883,499,1280,193
2006-2010 5-year estimates,17031833000,1476,478,998,1398,2970,814,2156,1882,798,68,147,75
2014-2018 5-year estimates,17031833000,2632,1500,1132,2054,4138,509,3629,2752,486,333,389,178
2006-2010 5-year estimates,17031832900,1286,895,391,1183,2392,713,1679,1250,134,193,782,33
2014-2018 5-year estimates,17031832900,1009,686,323,1673,2322,838,1484,1572,56,205,452,37
2006-2010 5-year estimates,17031832600,1943,691,1252,1704,4053,280,3773,3703,173,30,80,67
2014-2018 5-year estimates,17031832600,1899,824,1075,2097,3780,242,3538,3162,30,172,234,182
2006-2010 5-year estimates,17031832500,1611,788,823,827,3507,1080,2427,2644,353,350,150,10
2014-2018 5-year estimates,17031832500,1476,668,808,1747,3551,327,3224,2987,158,204,104,98
2006-2010 5-year estimates,17031832400,1363,675,688,1117,3831,1349,2482,1506,201,2022,55,47
2014-2018 5-year estimates,17031832400,1480,606,874,1722,3038,222,2816,1789,109,889,165,86
2006-2010 5-year estimates,17031832300,1073,590,483,1106,2316,86,2230,1554,0,656,78,28
2014-2018 5-year estimates,17031832300,964,514,450,1716,2001,144,1857,1205,24,462,188,122
2006-2010 5-year estimates,17031832200,1666,956,710,1084,3137,445,2692,2203,67,772,69,26
2014-2018 5-year estimates,17031832200,1647,985,662,1402,3289,210,3079,2469,39,482,82,217
2006-2010 5-year estimates,17031832100,1972,1310,662,885,3505,561,2944,2106,607,462,193,137
2014-2018 5-year estimates,17031832100,1970,1375,595,1309,3533,403,3130,2210,754,315,150,104
2006-2010 5-year estimates,17031832000,999,515,484,1316,2057,202,1855,1535,15,373,111,23
2014-2018 5-year estimates,17031832000,899,500,399,1820,1781,216,1565,1425,54,84,204,14
2006-2010 5-year estimates,17031831900,1496,752,744,1203,2908,64,2844,2715,0,64,129,0
2014-2018 5-year estimates,17031831900,1528,873,655,1703,2913,163,2750,2331,40,238,139,165
2006-2010 5-year estimates,17031831800,2388,1265,1123,862,7199,1145,6054,2496,209,1626,2400,468
2014-2018 5-year estimates,17031831800,2457,1353,1104,1089,6194,1022,5172,3114,123,1210,1416,331
2006-2010 5-year estimates,17031831700,816,345,471,977,2577,85,2492,880,51,1194,315,137
2014-2018 5-year estimates,17031831700,834,366,468,1092,2500,428,2072,651,9,1562,221,57
2006-2010 5-year estimates,17031831600,2616,1288,1328,802,6848,966,5882,2142,403,4070,197,36
2014-2018 5-year estimates,17031831600,2706,1204,1502,1004,7451,648,6803,1518,364,5259,3,307
2006-2010 5-year estimates,17031831500,1291,508,783,939,4095,561,3534,1139,74,2471,140,271
2014-2018 5-year estimates,17031831500,1339,489,850,1060,3720,435,3285,1073,88,2376,132,51
2006-2010 5-year estimates,17031831400,1186,816,370,723,3218,1529,1689,507,2146,455,91,19
2014-2018 5-year estimates,17031831400,1098,662,436,1048,2976,711,2265,280,1946,689,28,33
2006-2010 5-year estimates,17031831300,433,98,335,779,1282,388,894,99,665,365,100,53
2014-2018 5-year estimates,17031831300,392,155,237,1006,1047,219,828,15,536,464,17,15
2006-2010 5-year estimates,17031831200,1564,814,750,910,4931,1519,3412,301,278,4298,0,54
2014-2018 5-year estimates,17031831200,1643,901,742,862,4838,1011,3827,357,135,4280,66,0
2006-2010 5-year estimates,17031831100,2877,1459,1418,846,6959,793,6166,1915,66,4177,502,299
2014-2018 5-year estimates,17031831100,2940,1646,1294,1080,7891,805,7086,2610,26,4857,379,19
2006-2010 5-year estimates,17031831000,1216,490,726,1295,2242,87,2155,1700,38,119,319,66
2014-2018 5-year estimates,17031831000,1178,400,778,1997,2195,15,2180,1836,9,166,144,40
2006-2010 5-year estimates,17031830900,1373,731,642,1068,2854,537,2317,1386,86,1236,77,69
2014-2018 5-year estimates,17031830900,1401,688,713,1379,3089,170,2919,1591,135,1055,177,131
2006-2010 5-year estimates,17031830800,1458,1250,208,879,2202,126,2076,1575,163,302,151,11
2014-2018 5-year estimates,17031830800,1429,1152,277,1176,2512,153,2359,1961,22,420,82,27
2006-2010 5-year estimates,17031830700,1962,1324,638,606,3044,737,2307,1285,878,434,300,147
2014-2018 5-year estimates,17031830700,2067,1414,653,771,3693,923,2770,1540,1450,372,303,28
2006-2010 5-year estimates,17031830600,2257,1464,793,824,4651,1009,3642,1709,757,1626,298,261
2014-2018 5-year estimates,17031830600,2257,1694,563,971,4861,1128,3733,1655,649,2134,244,179
2006-2010 5-year estimates,17031830500,1263,325,938,894,4489,709,3780,198,158,4133,0,0
2014-2018 5-year estimates,17031830500,1256,429,827,956,4959,1542,3417,66,0,4893,0,0
2006-2010 5-year estimates,17031823304,2541,802,1739,778,5599,465,5134,3786,515,1045,191,62
2014-2018 5-year estimates,17031823304,2637,1133,1504,927,6138,644,5494,3074,1383,1568,86,27
2006-2010 5-year estimates,17031821402,1548,551,997,919,3775,378,3397,260,3465,50,0,0
2014-2018 5-year estimates,17031821402,1672,517,1155,895,2997,366,2631,87,2836,10,0,64
2006-2010 5-year estimates,17031810400,1943,173,1770,1107,5254,84,5170,4451,21,457,325,0
2014-2018 5-year estimates,17031810400,2055,214,1841,1280,5355,295,5060,4745,1,360,149,100
2006-2010 5-year estimates,17031770902,1713,551,1162,842,3537,265,3272,3309,0,126,102,0
2014-2018 5-year estimates,17031770902,1578,427,1151,979,3473,163,3310,3023,16,230,181,23
2006-2010 5-year estimates,17031770800,2091,720,1371,896,5843,777,5066,3783,229,1351,353,127
2014-2018 5-year estimates,17031770800,2107,758,1349,1151,5464,382,5082,3993,81,1088,52,250
2006-2010 5-year estimates,17031770700,1336,835,501,770,2501,250,2251,2254,59,131,57,0
2014-2018 5-year estimates,17031770700,1274,651,623,957,2451,265,2186,2087,29,300,35,0
2006-2010 5-year estimates,17031770602,1721,908,813,799,5284,967,4317,2291,155,2291,479,68
2014-2018 5-year estimates,17031770602,1669,929,740,973,5211,974,4237,1800,137,2763,454,57
2006-2010 5-year estimates,17031770500,1475,431,1044,770,4429,589,3840,876,107,3387,0,59
2014-2018 5-year estimates,17031770500,1186,322,864,1003,4223,1284,2939,747,0,3458,0,18
2006-2010 5-year estimates,17031760803,2926,1413,1513,931,6203,775,5428,4904,67,846,386,0
2014-2018 5-year estimates,17031760803,3085,1770,1315,1060,5707,856,4851,4609,70,432,469,127
2006-2010 5-year estimates,17031760802,1170,169,1001,1045,2379,207,2172,2051,0,118,180,30
2014-2018 5-year estimates,17031760802,1180,275,905,1056,2544,328,2216,2392,38,95,19,0
2006-2010 5-year estimates,17031760801,2246,1504,742,989,3266,167,3099,2259,63,445,452,47
2014-2018 5-year estimates,17031760801,2320,1794,526,1171,4298,464,3834,2398,146,526,877,351
2006-2010 5-year estimates,17031750600,1643,299,1344,1070,3977,919,3058,41,3890,8,23,15
2014-2018 5-year estimates,17031750600,1426,399,1027,1290,3663,1352,2311,25,3333,0,0,305
2006-2010 5-year estimates,17031750500,2179,631,1548,917,4950,866,4084,1059,3553,175,90,73
2014-2018 5-year estimates,17031750500,2346,889,1457,1164,5893,1438,4455,985,4532,338,4,34
2006-2010 5-year estimates,17031750400,1201,138,1063,845,3159,88,3071,2410,723,0,0,26
2014-2018 5-year estimates,17031750400,1227,242,985,865,3032,164,2868,1850,1003,179,0,0
2006-2010 5-year estimates,17031750300,971,194,777,933,2652,74,2578,2106,439,107,0,0
2014-2018 5-year estimates,17031750300,1000,201,799,1074,2494,97,2397,2034,284,130,19,27
2006-2010 5-year estimates,17031750200,1429,353,1076,850,2616,238,2378,955,1544,81,0,36
2014-2018 5-year estimates,17031750200,1422,389,1033,987,2778,300,2478,958,1533,126,0,161
2006-2010 5-year estimates,17031750100,1756,502,1254,914,4360,872,3488,204,3995,66,41,54
2014-2018 5-year estimates,17031750100,1591,429,1162,768,3814,740,3074,18,3587,148,0,61
2006-2010 5-year estimates,17031740400,1913,556,1357,850,4599,161,4438,3386,774,377,8,54
2014-2018 5-year estimates,17031740400,1977,530,1447,1109,4552,173,4379,3486,431,410,169,56
2006-2010 5-year estimates,17031740300,1816,121,1695,851,4639,93,4546,4400,0,239,0,0
2014-2018 5-year estimates,17031740300,1844,156,1688,1187,4947,134,4813,4280,111,433,41,82
2006-2010 5-year estimates,17031740200,2054,0,2054,0,6400,115,6285,5700,223,477,0,0
2014-2018 5-year estimates,17031740200,1978,112,1866,1205,6661,386,6275,5784,73,632,160,12
2006-2010 5-year estimates,17031740100,1269,194,1075,821,2859,94,2765,2619,0,230,0,10
2014-2018 5-year estimates,17031740100,1275,170,1105,1208,3182,115,3067,2747,0,363,0,72
2006-2010 5-year estimates,17031730700,857,124,733,883,2021,477,1544,9,1975,0,0,37
2014-2018 5-year estimates,17031730700,872,148,724,1136,2279,488,1791,14,2134,37,0,94
2006-2010 5-year estimates,17031730600,1414,277,1137,714,3725,291,3434,6,3679,0,0,40
2014-2018 5-year estimates,17031730600,1343,333,1010,782,3559,1093,2466,13,3522,14,0,10
2006-2010 5-year estimates,17031730500,1745,313,1432,1289,4569,818,3751,29,4412,56,0,72
2014-2018 5-year estimates,17031730500,1706,268,1438,984,4359,867,3492,10,4246,1,0,102
2006-2010 5-year estimates,17031730400,1463,311,1152,945,3557,466,3091,21,3505,31,0,0
2014-2018 5-year estimates,17031730400,1434,334,1100,1243,4067,529,3538,63,3859,55,0,90
2006-2010 5-year estimates,17031730300,471,196,275,885,1443,545,898,0,1223,0,0,220
2014-2018 5-year estimates,17031730300,474,162,312,970,1137,174,963,0,1097,0,11,29
2006-2010 5-year estimates,17031730202,1154,273,881,1096,3642,484,3158,12,3400,214,0,16
2014-2018 5-year estimates,17031730202,1127,368,759,1233,3550,422,3128,92,3420,6,3,29
2006-2010 5-year estimates,17031730201,2784,1537,1247,799,5984,1837,4147,49,5873,0,0,62
2014-2018 5-year estimates,17031730201,2627,1439,1188,810,5708,1650,4058,63,5594,27,24,0
2006-2010 5-year estimates,17031730100,1001,175,826,1076,2702,416,2286,6,2674,0,22,0
2014-2018 5-year estimates,17031730100,972,172,800,1020,2695,329,2366,13,2644,23,0,15
2006-2010 5-year estimates,17031720700,1547,775,772,821,3018,199,2819,1155,1700,115,48,0
2014-2018 5-year estimates,17031720700,1507,725,782,891,3066,169,2897,1114,1744,81,47,80
2006-2010 5-year estimates,17031720600,658,85,573,689,1834,125,1709,1492,300,42,0,0
2014-2018 5-year estimates,17031720600,643,71,572,1254,1751,42,1709,1133,536,65,5,12
2006-2010 5-year estimates,17031720500,813,41,772,814,2098,10,2088,1881,21,178,7,11
2014-2018 5-year estimates,17031720500,818,91,727,1141,2101,36,2065,1869,41,157,29,5
2006-2010 5-year estimates,17031720400,905,97,808,1086,2299,14,2285,2145,74,80,0,0
2014-2018 5-year estimates,17031720400,733,39,694,1183,1963,41,1922,1745,98,86,3,31
2006-2010 5-year estimates,17031720300,1371,50,1321,183,3759,101,3658,2320,1096,270,29,44
2014-2018 5-year estimates,17031720300,1384,28,1356,0,4100,217,3883,2153,1437,340,69,101
2006-2010 5-year estimates,17031720200,1706,485,1221,779,4455,414,4041,1492,2658,69,0,236
2014-2018 5-year estimates,17031720200,1728,410,1318,848,4047,405,3642,1580,2110,206,20,131
2006-2010 5-year estimates,17031720100,1496,19,1477,1080,4093,41,4052,2632,1295,140,0,26
2014-2018 5-year estimates,17031720100,1230,70,1160,0,3409,10,3399,2001,1170,161,17,60
2006-2010 5-year estimates,17031711500,910,199,711,751,3079,252,2827,0,3021,58,0,0
2014-2018 5-year estimates,17031711500,941,213,728,1425,2559,663,1896,0,2484,59,0,16
2006-2010 5-year estimates,17031711400,971,202,769,817,2390,471,1919,0,2263,82,0,45
2014-2018 5-year estimates,17031711400,949,324,625,890,2591,762,1829,2,2477,81,7,24
2006-2010 5-year estimates,17031711300,686,274,412,963,1640,635,1005,0,1567,57,16,0
2014-2018 5-year estimates,17031711300,676,336,340,1079,1794,429,1365,20,1739,35,0,0
2006-2010 5-year estimates,17031711200,2206,666,1540,798,5168,594,4574,62,5047,0,0,59
2014-2018 5-year estimates,17031711200,2127,823,1304,864,5007,876,4131,3,4905,26,0,73
2006-2010 5-year estimates,17031711100,1149,495,654,879,3754,1483,2271,0,3716,38,0,0
2014-2018 5-year estimates,17031711100,1151,375,776,747,2310,173,2137,0,2240,64,6,0
2006-2010 5-year estimates,17031711000,1457,680,777,995,3648,967,2681,52,3554,20,0,22
2014-2018 5-year estimates,17031711000,1402,615,787,845,3012,1030,1982,65,2876,0,26,45
2006-2010 5-year estimates,17031710900,829,309,520,998,2616,957,1659,0,2603,13,0,0
2014-2018 5-year estimates,17031710900,931,467,464,760,2018,763,1255,0,1923,77,0,18
2006-2010 5-year estimates,17031710800,2272,1168,1104,927,5112,808,4304,12,5017,21,0,62
2014-2018 5-year estimates,17031710800,2358,1313,1045,876,4741,1162,3579,4,4675,0,37,25
2006-2010 5-year estimates,17031710700,1458,825,633,873,3504,708,2796,38,3466,0,0,0
2014-2018 5-year estimates,17031710700,1596,961,635,679,2778,508,2270,4,2763,11,0,0
2006-2010 5-year estimates,17031710600,876,481,395,830,2343,1000,1343,0,2343,0,0,0
2014-2018 5-year estimates,17031710600,823,494,329,870,1767,519,1248,19,1709,0,0,39
2006-2010 5-year estimates,17031710500,1927,1274,653,814,4573,1322,3251,0,4529,26,0,18
2014-2018 5-year estimates,17031710500,1966,1269,697,902,4283,1088,3195,59,3979,142,27,76
2006-2010 5-year estimates,17031710400,2334,933,1401,881,6018,1751,4267,0,5906,40,58,14
2014-2018 5-year estimates,17031710400,2252,996,1256,975,5514,1594,3920,42,5383,66,0,23
2006-2010 5-year estimates,17031710300,664,484,180,698,1758,557,1201,0,1732,3,0,23
2014-2018 5-year estimates,17031710300,642,482,160,1011,1471,503,968,0,1245,159,0,67
2006-2010 5-year estimates,17031710200,2334,1642,692,770,6053,2240,3813,10,5976,67,0,0
2014-2018 5-year estimates,17031710200,2281,1443,838,893,4329,1221,3108,144,4083,72,17,13
2006-2010 5-year estimates,17031710100,592,405,187,769,1345,868,477,33,1304,0,0,8
2014-2018 5-year estimates,17031710100,631,451,180,731,1097,542,555,0,1048,44,0,5
2006-2010 5-year estimates,17031700502,1143,151,992,926,2910,175,2735,207,2694,9,0,0
2014-2018 5-year estimates,17031700502,1092,89,1003,0,3373,280,3093,180,3067,62,0,64
2006-2010 5-year estimates,17031700501,2645,423,2222,1016,7907,656,7251,363,7123,285,42,94
2014-2018 5-year estimates,17031700501,2626,719,1907,1135,6994,441,6553,210,5813,385,66,520
2006-2010 5-year estimates,17031700402,1385,35,1350,0,4229,326,3903,642,2840,719,0,28
2014-2018 5-year estimates,17031700402,1331,185,1146,1510,4498,1129,3369,473,2685,1340,0,0
2006-2010 5-year estimates,17031700401,1884,180,1704,944,6416,456,5960,841,3470,1971,80,54
2014-2018 5-year estimates,17031700401,1980,385,1595,1360,6643,1109,5534,326,4056,1988,83,190
2006-2010 5-year estimates,17031700302,1822,136,1686,879,5635,704,4931,1894,1276,2228,237,0
2014-2018 5-year estimates,17031700302,1849,256,1593,1140,5899,265,5634,1284,1112,3485,5,13
2006-2010 5-year estimates,17031700301,1708,222,1486,1084,5376,355,5021,1596,767,2876,97,40
2014-2018 5-year estimates,17031700301,1788,228,1560,1185,6389,562,5827,1134,764,4377,84,30
2006-2010 5-year estimates,17031700200,1854,261,1593,986,6539,1314,5225,1002,934,4462,17,124
2014-2018 5-year estimates,17031700200,1929,279,1650,1124,6638,644,5994,733,1025,4646,132,102
2006-2010 5-year estimates,17031700100,1126,294,832,1063,3370,559,2811,304,2345,721,0,0
2014-2018 5-year estimates,17031700100,1133,293,840,1016,3552,561,2991,84,2392,1020,0,56
2006-2010 5-year estimates,17031691500,1015,626,389,833,2123,847,1276,25,1923,158,0,17
2014-2018 5-year estimates,17031691500,981,600,381,842,1939,816,1123,23,1874,42,0,0
2006-2010 5-year estimates,17031691400,1799,715,1084,891,3512,787,2725,83,3375,28,26,0
2014-2018 5-year estimates,17031691400,1733,746,987,1055,2901,583,2318,0,2830,9,0,62
2006-2010 5-year estimates,17031691300,1197,524,673,739,2893,214,2679,0,2884,9,0,0
2014-2018 5-year estimates,17031691300,1211,571,640,889,2707,655,2052,20,2456,192,0,39
2006-2010 5-year estimates,17031691200,1409,789,620,746,2237,664,1573,0,2237,0,0,0
2014-2018 5-year estimates,17031691200,1334,855,479,918,2969,1107,1862,98,2783,0,0,88
2006-2010 5-year estimates,17031691100,1733,1118,615,721,3827,1653,2174,9,3800,18,0,0
2014-2018 5-year estimates,17031691100,1449,842,607,953,2993,1437,1556,60,2856,26,0,51
2006-2010 5-year estimates,17031691000,1426,677,749,818,2616,403,2213,17,2580,0,0,19
2014-2018 5-year estimates,17031691000,1311,701,610,902,2550,451,2099,4,2538,8,0,0
2006-2010 5-year estimates,17031690900,2429,1269,1160,817,4502,1216,3286,28,4402,43,0,29
2014-2018 5-year estimates,17031690900,2221,1484,737,894,4229,1514,2715,26,4049,14,0,140
2006-2010 5-year estimates,17031690500,508,297,211,904,1495,221,1274,0,1495,0,0,0
2014-2018 5-year estimates,17031690500,500,272,228,865,624,270,354,0,624,0,0,0
2006-2010 5-year estimates,17031690400,2013,1357,656,829,3688,819,2869,0,3550,118,20,0
2014-2018 5-year estimates,17031690400,1886,1181,705,866,3031,1194,1837,4,2998,6,0,23
2006-2010 5-year estimates,17031690300,1005,789,216,794,2157,1180,977,7,2133,9,0,8
2014-2018 5-year estimates,17031690300,927,843,84,708,2454,1455,999,88,2327,10,0,29
2006-2010 5-year estimates,17031681400,1344,736,608,855,3252,1681,1571,11,3230,0,0,11
2014-2018 5-year estimates,17031681400,1328,400,928,946,2433,696,1737,0,2349,57,0,27
2006-2010 5-year estimates,17031681300,1433,951,482,950,3241,1394,1847,0,3241,0,0,0
2014-2018 5-year estimates,17031681300,1308,601,707,837,2279,914,1365,7,2137,135,0,0
2006-2010 5-year estimates,17031681200,1305,770,535,765,3228,1846,1382,9,3179,0,0,40
2014-2018 5-year estimates,17031681200,1210,679,531,874,2511,984,1527,0,2319,160,0,32
2006-2010 5-year estimates,17031681100,1787,960,827,877,4028,1571,2457,10,3999,19,0,0
2014-2018 5-year estimates,17031681100,1659,861,798,987,2910,1275,1635,10,2689,196,1,14
2006-2010 5-year estimates,17031681000,1684,976,708,779,3501,1673,1828,89,3329,9,0,74
2014-2018 5-year estimates,17031681000,1655,791,864,797,2641,1223,1418,32,2565,0,0,44
2006-2010 5-year estimates,17031680900,2176,1617,559,536,3960,1806,2154,40,3868,47,0,5
2014-2018 5-year estimates,17031680900,2192,1655,537,646,3430,1300,2130,31,3370,9,20,0
2006-2010 5-year estimates,17031680600,739,444,295,772,1516,841,675,0,1516,0,0,0
2014-2018 5-year estimates,17031680600,644,264,380,840,1308,698,610,33,1263,0,12,0
2006-2010 5-year estimates,17031680500,634,323,311,920,1623,586,1037,0,1564,59,0,0
2014-2018 5-year estimates,17031680500,671,307,364,888,1333,599,734,22,1261,50,0,0
2006-2010 5-year estimates,17031672000,1321,314,1007,1159,4143,1458,2685,73,3962,45,0,63
2014-2018 5-year estimates,17031672000,1291,488,803,1131,4064,870,3194,29,3942,27,0,66
2006-2010 5-year estimates,17031671900,452,139,313,775,1288,240,1048,0,1288,0,0,0
2014-2018 5-year estimates,17031671900,437,81,356,1099,1162,211,951,24,1028,110,0,0
2006-2010 5-year estimates,17031671800,565,212,353,1115,1137,550,587,11,1051,75,0,0
2014-2018 5-year estimates,17031671800,468,147,321,1125,1256,440,816,3,1142,68,0,43
2006-2010 5-year estimates,17031671600,1061,671,390,829,2716,1176,1540,0,2599,0,0,117
2014-2018 5-year estimates,17031671600,974,549,425,794,2016,522,1494,39,1903,39,0,35
2006-2010 5-year estimates,17031671500,1245,532,713,1051,3665,1165,2500,77,3422,107,0,59
2014-2018 5-year estimates,17031671500,1147,427,720,864,2343,719,1624,26,1772,437,0,108
2006-2010 5-year estimates,17031671400,673,165,508,635,1623,304,1319,12,1513,79,0,19
2014-2018 5-year estimates,17031671400,628,198,430,1185,1394,597,797,0,1316,78,0,0
2006-2010 5-year estimates,17031671300,926,529,397,849,3146,1674,1472,46,3071,10,0,19
2014-2018 5-year estimates,17031671300,826,366,460,690,1905,469,1436,1,1805,99,0,0
2006-2010 5-year estimates,17031671200,539,268,271,888,1376,416,960,8,1368,0,0,0
2014-2018 5-year estimates,17031671200,500,276,224,1011,939,401,538,13,926,0,0,0
2006-2010 5-year estimates,17031671100,469,250,219,934,1328,582,746,0,1298,0,0,30
2014-2018 5-year estimates,17031671100,438,228,210,996,1044,502,542,6,1010,2,0,26
2006-2010 5-year estimates,17031670900,689,250,439,849,1534,482,1052,0,1502,0,0,32
2014-2018 5-year estimates,17031670900,633,231,402,987,1457,479,978,55,1293,75,0,34
2006-2010 5-year estimates,17031670800,801,455,346,963,1831,487,1344,0,1706,125,0,0
2014-2018 5-year estimates,17031670800,716,381,335,792,1263,426,837,0,1239,24,0,0
2006-2010 5-year estimates,17031670700,549,255,294,1158,1697,1039,658,16,1670,0,0,11
2014-2018 5-year estimates,17031670700,511,185,326,989,1072,362,710,1,890,181,0,0
2006-2010 5-year estimates,17031670600,633,277,356,742,1575,614,961,0,1534,0,0,41
2014-2018 5-year estimates,17031670600,498,160,338,785,1050,332,718,5,985,56,0,4
2006-2010 5-year estimates,17031670500,492,155,337,946,1099,297,802,0,1099,0,0,0
2014-2018 5-year estimates,17031670500,474,196,278,873,1047,270,777,5,746,278,0,18
2006-2010 5-year estimates,17031670400,678,337,341,990,3658,2363,1295,6,3425,186,0,41
2014-2018 5-year estimates,17031670400,665,327,338,934,1656,570,1086,0,1326,325,0,5
2006-2010 5-year estimates,17031670300,662,271,391,942,1565,1041,524,28,1456,25,28,28
2014-2018 5-year estimates,17031670300,599,266,333,785,1126,446,680,17,822,253,4,30
2006-2010 5-year estimates,17031670200,629,279,350,930,1511,473,1038,0,1511,0,0,0
2014-2018 5-year estimates,17031670200,534,234,300,907,884,457,427,32,823,24,0,5
2006-2010 5-year estimates,17031670100,635,274,361,1059,1372,429,943,6,1318,48,0,0
2014-2018 5-year estimates,17031670100,586,254,332,752,944,255,689,36,798,110,0,0
2006-2010 5-year estimates,17031661100,2015,632,1383,957,5961,668,5293,483,3065,2386,6,21
2014-2018 5-year estimates,17031661100,2020,636,1384,1104,6851,945,5906,278,2742,3637,4,190
2006-2010 5-year estimates,17031661000,2160,844,1316,809,5657,1024,4633,116,5356,98,0,87
2014-2018 5-year estimates,17031661000,2182,1136,1046,1006,5157,1336,3821,27,4423,638,9,60
2006-2010 5-year estimates,17031660900,1855,1239,616,884,4826,1554,3272,329,4147,340,0,10
2014-2018 5-year estimates,17031660900,1859,1199,660,993,4694,1690,3004,93,3706,573,25,297
2006-2010 5-year estimates,17031660800,2253,1357,896,799,6134,1791,4343,182,4398,1463,0,91
2014-2018 5-year estimates,17031660800,2204,1338,866,871,4887,933,3954,136,2589,2003,37,122
2006-2010 5-year estimates,17031660700,752,297,455,871,2123,622,1501,60,2012,42,9,0
2014-2018 5-year estimates,17031660700,724,324,400,922,1666,408,1258,28,1524,114,0,0
2006-2010 5-year estimates,17031660600,2363,1404,959,820,6049,1772,4277,74,3540,2314,121,0
2014-2018 5-year estimates,17031660600,2455,1536,919,845,5845,1853,3992,248,2949,2544,0,104
2006-2010 5-year estimates,17031660500,1516,722,794,818,4841,1041,3800,580,967,3252,0,42
2014-2018 5-year estimates,17031660500,1499,794,705,803,4720,1270,3450,290,376,4036,18,0
2006-2010 5-year estimates,17031660400,1605,701,904,696,5543,1425,4118,387,191,4862,0,103
2014-2018 5-year estimates,17031660400,1594,609,985,754,6034,778,5256,430,146,5458,0,0
2006-2010 5-year estimates,17031660302,1585,832,753,889,5437,707,4730,83,1118,4060,58,118
2014-2018 5-year estimates,17031660302,1681,1037,644,896,5020,1235,3785,174,1123,3600,58,65
2006-2010 5-year estimates,17031660301,680,542,138,757,1556,524,1032,78,1148,330,0,0
2014-2018 5-year estimates,17031660301,660,435,225,756,1507,494,1013,47,499,955,0,6
2006-2010 5-year estimates,17031650500,1642,239,1403,1706,4709,636,4073,776,551,3312,60,10
2014-2018 5-year estimates,17031650500,1673,309,1364,981,4549,528,4021,663,363,3463,10,50
2006-2010 5-year estimates,17031650400,1734,371,1363,1067,6301,1752,4549,681,158,5453,0,9
2014-2018 5-year estimates,17031650400,1806,428,1378,1109,6530,1025,5505,425,256,5741,108,0
2006-2010 5-year estimates,17031650302,1169,28,1141,982,4036,803,3233,733,35,3227,0,41
2014-2018 5-year estimates,17031650302,1142,262,880,1045,4195,734,3461,334,96,3750,0,15
2006-2010 5-year estimates,17031650301,1643,384,1259,878,5570,891,4679,901,96,4573,0,0
2014-2018 5-year estimates,17031650301,1660,369,1291,1044,5276,274,5002,919,29,4205,106,17
2006-2010 5-year estimates,17031650200,2105,741,1364,870,6960,675,6285,2349,40,4403,0,168
2014-2018 5-year estimates,17031650200,2273,900,1373,965,7211,1175,6036,1488,0,5723,0,0
2006-2010 5-year estimates,17031650100,1366,365,1001,1046,5122,1327,3795,802,175,3952,0,193
2014-2018 5-year estimates,17031650100,1339,542,797,883,4415,817,3598,596,86,3726,0,7
2006-2010 5-year estimates,17031640800,559,107,452,771,1663,226,1437,471,62,1130,0,0
2014-2018 5-year estimates,17031640800,564,142,422,931,1805,226,1579,380,43,1372,7,3
2006-2010 5-year estimates,17031640700,1117,224,893,997,3230,145,3085,1422,0,1802,6,0
2014-2018 5-year estimates,17031640700,1107,256,851,1284,3608,613,2995,1204,82,2322,0,0
2006-2010 5-year estimates,17031640600,1751,767,984,806,4167,204,3963,2258,0,1781,128,0
2014-2018 5-year estimates,17031640600,1772,817,955,898,4022,881,3141,1657,62,2257,28,18
2006-2010 5-year estimates,17031640500,1552,213,1339,820,3555,217,3338,2180,0,1338,37,0
2014-2018 5-year estimates,17031640500,1571,438,1133,954,3970,127,3843,1884,28,1961,86,11
2006-2010 5-year estimates,17031640400,1261,283,978,905,3125,81,3044,2047,0,1078,0,0
2014-2018 5-year estimates,17031640400,1299,260,1039,913,3701,178,3523,2002,80,1378,10,231
2006-2010 5-year estimates,17031640300,2450,465,1985,759,7042,549,6493,3726,231,2969,0,116
2014-2018 5-year estimates,17031640300,2448,856,1592,1024,7157,286,6871,2374,63,4656,0,64
2006-2010 5-year estimates,17031640100,477,148,329,743,1283,114,1169,296,0,971,16,0
2014-2018 5-year estimates,17031640100,510,274,236,986,1472,147,1325,480,58,894,10,30
2006-2010 5-year estimates,17031630900,1392,620,772,780,5083,783,4300,234,32,4769,48,0
2014-2018 5-year estimates,17031630900,1391,584,807,908,5290,704,4586,224,62,4971,33,0
2006-2010 5-year estimates,17031630800,1772,666,1106,787,6512,1472,5040,441,280,5780,11,0
2014-2018 5-year estimates,17031630800,1823,719,1104,787,7111,903,6208,237,212,6662,0,0
2006-2010 5-year estimates,17031630500,1632,714,918,799,5882,1053,4829,234,179,5469,0,0
2014-2018 5-year estimates,17031630500,1704,796,908,905,6098,1329,4769,133,120,5845,0,0
2006-2010 5-year estimates,17031630400,1744,681,1063,850,6740,1800,4940,344,10,6377,0,9
2014-2018 5-year estimates,17031630400,1891,931,960,841,6829,1659,5170,349,54,6426,0,0
2006-2010 5-year estimates,17031630300,1410,437,973,706,5315,1169,4146,347,0,4892,0,76
2014-2018 5-year estimates,17031630300,1433,661,772,911,5474,558,4916,304,0,5116,54,0
2006-2010 5-year estimates,17031630200,597,270,327,743,2251,617,1634,192,0,2005,54,0
2014-2018 5-year estimates,17031630200,626,376,250,791,2045,540,1505,103,17,1842,83,0
2006-2010 5-year estimates,17031630100,374,247,127,788,1438,499,939,61,300,1077,0,0
2014-2018 5-year estimates,17031630100,363,203,160,678,950,238,712,55,185,710,0,0
2006-2010 5-year estimates,17031620400,1342,220,1122,1147,4856,466,4390,705,199,3884,54,14
2014-2018 5-year estimates,17031620400,1366,277,1089,1070,4503,338,4165,399,46,4051,0,7
2006-2010 5-year estimates,17031620300,1965,505,1460,921,6440,844,5596,1851,0,4532,57,0
2014-2018 5-year estimates,17031620300,2124,741,1383,1137,7784,957,6827,1468,245,6057,0,14
2006-2010 5-year estimates,17031620200,884,374,510,843,2364,158,2206,561,11,1577,195,20
2014-2018 5-year estimates,17031620200,778,262,516,989,2230,167,2063,574,0,1564,92,0
2006-2010 5-year estimates,17031620100,1129,169,960,909,4247,637,3610,576,128,3445,28,70
2014-2018 5-year estimates,17031620100,1247,263,984,1052,4819,660,4159,418,0,4081,320,0
2006-2010 5-year estimates,17031612100,608,350,258,679,1585,406,1179,16,1569,0,0,0
2014-2018 5-year estimates,17031612100,579,284,295,866,1042,259,783,19,938,85,0,0
2006-2010 5-year estimates,17031612000,642,232,410,1539,1676,912,764,0,1670,2,4,0
2014-2018 5-year estimates,17031612000,647,290,357,910,1373,227,1146,36,1255,77,5,0
2006-2010 5-year estimates,17031611900,865,442,423,892,2484,1083,1401,8,2087,389,0,0
2014-2018 5-year estimates,17031611900,784,440,344,774,1729,735,994,24,1332,335,0,38
2006-2010 5-year estimates,17031611800,870,518,352,962,2369,500,1869,196,1485,670,0,18
2014-2018 5-year estimates,17031611800,879,542,337,888,2390,538,1852,38,1407,945,0,0
2006-2010 5-year estimates,17031611700,872,332,540,859,2258,1129,1129,50,1785,401,0,22
2014-2018 5-year estimates,17031611700,733,412,321,850,1706,768,938,0,700,992,0,14
2006-2010 5-year estimates,17031611600,568,218,350,1070,2119,494,1625,0,1382,594,0,143
2014-2018 5-year estimates,17031611600,601,285,316,684,1608,362,1246,35,597,951,5,20
2006-2010 5-year estimates,17031611500,1205,635,570,755,3564,827,2737,80,338,3146,0,0
2014-2018 5-year estimates,17031611500,1133,767,366,774,3362,1281,2081,141,256,2942,12,11
2006-2010 5-year estimates,17031611400,1239,717,522,671,3935,1786,2149,179,118,3601,0,37
2014-2018 5-year estimates,17031611400,1215,841,374,729,3060,1086,1974,87,24,2910,0,39
2006-2010 5-year estimates,17031611300,1149,620,529,784,3304,991,2313,261,220,2769,0,54
2014-2018 5-year estimates,17031611300,1093,747,346,749,2521,650,1871,127,187,2207,0,0
2006-2010 5-year estimates,17031611200,874,438,436,762,2311,684,1627,204,616,1480,11,0
2014-2018 5-year estimates,17031611200,877,656,221,740,2496,904,1592,215,507,1758,8,8
2006-2010 5-year estimates,17031611100,976,534,442,614,2286,1022,1264,149,486,1591,28,32
2014-2018 5-year estimates,17031611100,940,589,351,738,2326,782,1544,160,361,1780,0,25
2006-2010 5-year estimates,17031611000,388,208,180,858,963,796,167,15,662,262,0,24
2014-2018 5-year estimates,17031611000,382,227,155,828,891,415,476,34,493,355,9,0
2006-2010 5-year estimates,17031610800,614,109,505,861,1245,76,1169,1084,0,161,0,0
2014-2018 5-year estimates,17031610800,623,277,346,962,1509,115,1394,954,0,409,44,102
2006-2010 5-year estimates,17031610400,693,402,291,635,1795,454,1341,0,0,1795,0,0
2014-2018 5-year estimates,17031610400,750,508,242,762,1981,830,1151,33,16,1932,0,0
2006-2010 5-year estimates,17031610300,1827,1089,738,651,5216,2149,3067,433,25,4646,39,73
2014-2018 5-year estimates,17031610300,1872,1088,784,711,5941,1753,4188,221,206,5214,276,24
2006-2010 5-year estimates,17031600900,1827,1029,798,761,3615,987,2628,1312,175,972,1088,68
2014-2018 5-year estimates,17031600900,1638,977,661,998,3466,388,3078,1448,281,609,1115,13
2006-2010 5-year estimates,17031600700,1125,526,599,752,2413,509,1904,735,59,1099,520,0
2014-2018 5-year estimates,17031600700,1167,623,544,1023,2579,462,2117,1056,82,712,682,47
2006-2010 5-year estimates,17031600600,1193,470,723,828,2389,485,1904,893,0,690,790,16
2014-2018 5-year estimates,17031600600,1158,653,505,865,3125,519,2606,587,39,1202,1297,0
2006-2010 5-year estimates,17031600400,1704,860,844,771,4213,619,3594,878,99,751,2395,90
2014-2018 5-year estimates,17031600400,1643,940,703,933,4413,1249,3164,924,66,661,2752,10
2006-2010 5-year estimates,17031590700,1138,520,618,773,2666,288,2378,453,126,1726,350,11
2014-2018 5-year estimates,17031590700,1099,605,494,907,3393,1008,2385,418,45,2341,533,56
2006-2010 5-year estimates,17031590600,1349,565,784,823,3729,392,3337,1181,38,2186,313,11
2014-2018 5-year estimates,17031590600,1301,561,740,925,3678,673,3005,770,10,2486,344,68
2006-2010 5-year estimates,17031590500,692,300,392,744,1895,153,1742,404,0,1182,269,40
2014-2018 5-year estimates,17031590500,708,312,396,938,1842,394,1448,314,29,887,612,0
2006-2010 5-year estimates,17031580800,597,309,288,748,1806,222,1584,134,20,1652,0,0
2014-2018 5-year estimates,17031580800,622,355,267,869,2213,363,1850,73,0,2115,15,10
2006-2010 5-year estimates,17031580700,1733,857,876,776,5598,1545,4053,363,0,4954,281,0
2014-2018 5-year estimates,17031580700,1826,813,1013,844,6238,1129,5109,337,80,5456,313,52
2006-2010 5-year estimates,17031580600,1687,926,761,808,5896,1274,4622,408,214,4726,514,34
2014-2018 5-year estimates,17031580600,1681,758,923,755,5174,911,4263,603,112,4194,264,1
2006-2010 5-year estimates,17031580502,1378,631,747,694,4475,828,3647,720,105,3136,490,24
2014-2018 5-year estimates,17031580502,1606,770,836,814,5581,1183,4398,521,23,4439,473,125
2006-2010 5-year estimates,17031580501,1692,828,864,796,5802,1311,4491,699,0,4793,278,32
2014-2018 5-year estimates,17031580501,1637,945,692,835,4981,1270,3711,424,13,4278,258,8
2006-2010 5-year estimates,17031580400,1500,661,839,733,3758,842,2916,612,0,2867,208,71
2014-2018 5-year estimates,17031580400,1635,752,883,852,4712,829,3883,419,5,3717,571,0
2006-2010 5-year estimates,17031580300,688,283,405,865,2496,379,2117,87,0,2350,59,0
2014-2018 5-year estimates,17031580300,743,360,383,838,2555,258,2297,130,72,1982,371,0
2006-2010 5-year estimates,17031580200,1024,493,531,782,3825,1075,2750,295,0,3285,237,8
2014-2018 5-year estimates,17031580200,1026,420,606,921,3784,972,2812,223,11,3177,323,50
2006-2010 5-year estimates,17031580100,985,501,484,806,2962,797,2165,356,109,2262,235,0
2014-2018 5-year estimates,17031580100,956,403,553,993,2758,507,2251,121,107,1752,695,83
2006-2010 5-year estimates,17031570500,771,262,509,917,2686,561,2125,561,129,1996,0,0
2014-2018 5-year estimates,17031570500,788,427,361,966,2290,316,1974,477,24,1629,152,8
2006-2010 5-year estimates,17031570400,590,204,386,679,1590,235,1355,150,0,1424,0,16
2014-2018 5-year estimates,17031570400,589,289,300,855,1725,152,1573,178,1,1517,29,0
2006-2010 5-year estimates,17031570300,1795,654,1141,920,5739,671,5068,1634,0,4044,0,61
2014-2018 5-year estimates,17031570300,1913,874,1039,970,5691,1150,4541,854,98,4572,156,11
2006-2010 5-year estimates,17031570200,587,91,496,1250,1626,24,1602,561,0,1065,0,0
2014-2018 5-year estimates,17031570200,630,128,502,675,2074,471,1603,377,0,1488,209,0
2006-2010 5-year estimates,17031570100,399,150,249,1039,1318,109,1209,352,0,966,0,0
2014-2018 5-year estimates,17031570100,444,158,286,872,1302,201,1101,250,0,923,104,25
2006-2010 5-year estimates,17031561100,2002,152,1850,760,5631,332,5299,3646,0,1961,24,0
2014-2018 5-year estimates,17031561100,2030,189,1841,750,5502,237,5265,2788,12,2702,0,0
2006-2010 5-year estimates,17031561000,2100,229,1871,717,5297,281,5016,4012,0,1285,0,0
2014-2018 5-year estimates,17031561000,2151,293,1858,905,6064,158,5906,3242,49,2635,0,138
2006-2010 5-year estimates,17031560900,1953,96,1857,1545,5143,41,5102,3943,0,1172,28,0
2014-2018 5-year estimates,17031560900,1972,212,1760,1495,5341,80,5261,3128,19,2080,46,68
2006-2010 5-year estimates,17031560800,2213,552,1661,1026,5688,353,5335,3271,0,2337,0,80
2014-2018 5-year estimates,17031560800,2243,460,1783,1123,5886,388,5498,2774,144,2935,0,33
2006-2010 5-year estimates,17031560700,1315,443,872,833,3607,584,3023,1594,0,1822,125,66
2014-2018 5-year estimates,17031560700,1319,494,825,1015,3726,455,3271,1508,42,2159,7,10
2006-2010 5-year estimates,17031560400,440,0,440,0,1472,155,1317,402,0,999,61,10
2014-2018 5-year estimates,17031560400,455,51,404,1175,1585,204,1381,395,33,1090,67,0
2006-2010 5-year estimates,17031560300,964,48,916,0,3233,268,2965,774,185,2014,260,0
2014-2018 5-year estimates,17031560300,1009,116,893,1377,3145,415,2730,970,31,1997,86,61
2006-2010 5-year estimates,17031560200,1170,351,819,688,2885,1010,1875,99,2661,59,51,15
2014-2018 5-year estimates,17031560200,649,115,534,984,1654,319,1335,121,1122,390,0,21
2006-2010 5-year estimates,17031560100,351,143,208,1095,797,144,653,243,0,470,84,0
2014-2018 5-year estimates,17031560100,361,113,248,829,1539,139,1400,168,206,1007,137,21
2006-2010 5-year estimates,17031550200,1108,90,1018,0,2726,286,2440,1197,72,1453,0,4
2014-2018 5-year estimates,17031550200,1133,182,951,1076,2726,150,2576,1104,108,1514,0,0
2006-2010 5-year estimates,17031550100,3096,922,2174,760,8030,1124,6906,3457,694,3809,22,48
2014-2018 5-year estimates,17031550100,2823,848,1975,827,6479,1639,4840,2501,352,3605,0,21
2006-2010 5-year estimates,17031540102,1368,939,429,463,3354,2150,1204,20,3334,0,0,0
2014-2018 5-year estimates,17031540102,1356,1006,350,452,3207,2059,1148,107,3089,11,0,0
2006-2010 5-year estimates,17031540101,2022,1005,1017,306,2534,1381,1153,0,2417,77,40,0
2014-2018 5-year estimates,17031540101,1886,1502,384,365,4055,2145,1910,24,3831,178,22,0
2006-2010 5-year estimates,17031530600,1450,666,784,839,3817,866,2951,29,3788,0,0,0
2014-2018 5-year estimates,17031530600,1239,525,714,899,2653,764,1889,11,2573,5,0,64
2006-2010 5-year estimates,17031530503,2038,310,1728,1091,5901,732,5169,0,5819,0,0,82
2014-2018 5-year estimates,17031530503,1994,553,1441,1301,5973,1720,4253,9,5779,43,0,142
2006-2010 5-year estimates,17031530502,623,74,549,1315,1696,153,1543,0,1696,0,0,0
2014-2018 5-year estimates,17031530502,590,88,502,1350,1552,337,1215,0,1492,49,0,11
2006-2010 5-year estimates,17031530501,2204,954,1250,1087,6228,2473,3755,26,6115,0,0,87
2014-2018 5-year estimates,17031530501,2061,803,1258,794,4644,929,3715,89,4431,58,0,66
2006-2010 5-year estimates,17031530400,794,149,645,825,1927,428,1499,24,1780,123,0,0
2014-2018 5-year estimates,17031530400,811,136,675,1322,2053,482,1571,30,1982,4,19,18
2006-2010 5-year estimates,17031530300,1672,274,1398,1199,4406,793,3613,5,4304,90,0,7
2014-2018 5-year estimates,17031530300,1674,322,1352,982,4440,972,3468,7,4372,31,0,30
2006-2010 5-year estimates,17031530200,2162,923,1239,1046,5636,2091,3545,30,5516,81,0,9
2014-2018 5-year estimates,17031530200,1929,720,1209,986,3920,1270,2650,30,3881,0,0,9
2006-2010 5-year estimates,17031530100,1068,615,453,763,2977,887,2090,86,1783,1108,0,0
2014-2018 5-year estimates,17031530100,967,402,565,709,2236,595,1641,9,799,1380,0,48
2006-2010 5-year estimates,17031520600,854,60,794,757,2949,150,2799,604,53,2263,29,0
2014-2018 5-year estimates,17031520600,845,160,685,1047,2809,466,2343,640,0,2138,31,0
2006-2010 5-year estimates,17031520500,1540,144,1396,822,4570,503,4067,1551,0,2975,11,33
2014-2018 5-year estimates,17031520500,1614,283,1331,799,5109,582,4527,1439,84,3538,0,48
2006-2010 5-year estimates,17031520400,1454,390,1064,762,4675,1038,3637,918,11,3746,0,0
2014-2018 5-year estimates,17031520400,1452,455,997,914,4656,759,3897,501,90,4057,8,0
2006-2010 5-year estimates,17031520300,2000,513,1487,764,7089,1538,5551,710,26,6301,19,33
2014-2018 5-year estimates,17031520300,1964,545,1419,864,5857,1622,4235,579,191,5087,0,0
2006-2010 5-year estimates,17031520200,1394,745,649,777,4043,1350,2693,305,252,3486,0,0
2014-2018 5-year estimates,17031520200,1352,769,583,746,3989,997,2992,250,365,3366,8,0
2006-2010 5-year estimates,17031520100,686,308,378,734,1890,644,1246,150,140,1593,0,7
2014-2018 5-year estimates,17031520100,678,159,519,796,1810,246,1564,125,73,1612,0,0
2006-2010 5-year estimates,17031510300,2240,658,1582,939,5819,1280,4539,14,5482,92,40,191
2014-2018 5-year estimates,17031510300,2213,887,1326,1134,5126,1164,3962,18,5086,22,0,0
2006-2010 5-year estimates,17031510200,1239,354,885,1363,3336,917,2419,150,2736,450,0,0
2014-2018 5-year estimates,17031510200,1195,257,938,1198,3321,1056,2265,196,2252,833,1,39
2006-2010 5-year estimates,17031510100,1215,279,936,814,3864,1028,2836,873,32,2945,0,14
2014-2018 5-year estimates,17031510100,1225,478,747,746,3077,726,2351,287,443,2342,0,5
2006-2010 5-year estimates,17031500300,966,456,510,749,1844,459,1385,545,775,524,0,0
2014-2018 5-year estimates,17031500300,969,418,551,867,1477,374,1103,621,496,257,5,98
2006-2010 5-year estimates,17031500200,908,396,512,1009,2024,789,1235,0,1945,79,0,0
2014-2018 5-year estimates,17031500200,970,587,383,913,2131,793,1338,35,2051,0,0,45
2006-2010 5-year estimates,17031500100,1721,838,883,777,3855,594,3261,10,3759,86,0,0
2014-2018 5-year estimates,17031500100,1577,720,857,911,3208,343,2865,19,3144,45,0,0
2006-2010 5-year estimates,17031491400,1447,978,469,850,3423,1112,2311,10,3390,0,0,23
2014-2018 5-year estimates,17031491400,1550,996,554,952,3567,1238,2329,73,3392,76,0,26
2006-2010 5-year estimates,17031491300,1164,516,648,969,3112,927,2185,9,3093,10,0,0
2014-2018 5-year estimates,17031491300,974,310,664,1084,2605,1271,1334,22,2527,45,0,11
2006-2010 5-year estimates,17031491200,857,192,665,1125,2624,320,2304,13,2593,18,0,0
2014-2018 5-year estimates,17031491200,848,243,605,1097,2110,565,1545,48,1835,99,19,109
2006-2010 5-year estimates,17031491100,1692,320,1372,1253,5198,1196,4002,52,5087,9,0,50
2014-2018 5-year estimates,17031491100,1623,400,1223,1193,4160,757,3403,79,3929,101,0,51
2006-2010 5-year estimates,17031491000,2068,741,1327,1122,5863,1999,3864,44,5640,57,0,122
2014-2018 5-year estimates,17031491000,1728,648,1080,1047,4239,2060,2179,57,4087,18,12,65
2006-2010 5-year estimates,17031490902,2205,835,1370,843,5583,1251,4332,11,5550,0,0,22
2014-2018 5-year estimates,17031490902,2171,855,1316,880,4355,666,3689,9,4266,32,27,21
2006-2010 5-year estimates,17031490901,1810,1136,674,772,3599,1098,2501,0,3599,0,0,0
2014-2018 5-year estimates,17031490901,1782,962,820,894,3689,893,2796,1,3608,72,0,8
2006-2010 5-year estimates,17031490800,1651,329,1322,938,3763,500,3263,71,3665,0,0,27
2014-2018 5-year estimates,17031490800,1639,487,1152,926,4116,1078,3038,73,3985,11,14,33
2006-2010 5-year estimates,17031490700,1152,217,935,951,3464,662,2802,0,3422,0,0,42
2014-2018 5-year estimates,17031490700,1101,308,793,1068,2720,607,2113,0,2708,12,0,0
2006-2010 5-year estimates,17031490600,617,115,502,1149,1488,312,1176,10,1407,0,37,34
2014-2018 5-year estimates,17031490600,608,97,511,1551,1498,244,1254,22,1442,0,34,0
2006-2010 5-year estimates,17031490500,870,176,694,777,2508,163,2345,24,2354,103,13,14
2014-2018 5-year estimates,17031490500,853,218,635,1095,2008,394,1614,81,1815,31,12,69
2006-2010 5-year estimates,17031490400,488,160,328,842,1270,351,919,0,1270,0,0,0
2014-2018 5-year estimates,17031490400,454,144,310,1076,773,43,730,0,773,0,0,0
2006-2010 5-year estimates,17031490300,1016,270,746,892,2179,425,1754,15,2091,17,0,56
2014-2018 5-year estimates,17031490300,982,321,661,1121,2340,442,1898,16,2218,36,0,70
2006-2010 5-year estimates,17031480500,1348,377,971,695,3231,553,2678,85,2726,396,0,24
2014-2018 5-year estimates,17031480500,1286,397,889,943,2938,608,2330,46,2569,315,8,0
2006-2010 5-year estimates,17031480400,2655,380,2275,959,6760,960,5800,47,6633,66,14,0
2014-2018 5-year estimates,17031480400,2547,338,2209,1000,5584,698,4886,92,5371,101,0,20
2006-2010 5-year estimates,17031480300,688,262,426,1144,1447,289,1158,0,1447,0,0,0
2014-2018 5-year estimates,17031480300,618,258,360,981,1103,272,831,16,1046,24,7,10
2006-2010 5-year estimates,17031480200,602,320,282,794,1365,156,1209,0,1307,0,58,0
2014-2018 5-year estimates,17031480200,635,233,402,1041,1139,180,959,0,1097,11,0,31
2006-2010 5-year estimates,17031480100,986,147,839,788,2151,234,1917,0,2099,52,0,0
2014-2018 5-year estimates,17031480100,969,195,774,991,2192,151,2041,18,2152,7,0,15
2006-2010 5-year estimates,17031470100,1250,530,720,592,3432,1081,2351,74,3358,0,0,0
2014-2018 5-year estimates,17031470100,1324,631,693,672,2336,413,1923,10,2265,37,0,24
2006-2010 5-year estimates,17031461000,917,596,321,374,1377,284,1093,88,733,556,0,0
2014-2018 5-year estimates,17031461000,990,708,282,338,1313,406,907,73,817,407,0,16
2006-2010 5-year estimates,17031460700,1439,976,463,591,3847,2066,1781,64,1686,2088,0,9
2014-2018 5-year estimates,17031460700,1292,670,622,689,2636,1189,1447,85,1437,1049,18,47
2006-2010 5-year estimates,17031460600,496,310,186,950,1258,564,694,21,1082,139,0,16
2014-2018 5-year estimates,17031460600,466,239,227,880,1008,196,812,7,794,207,0,0
2006-2010 5-year estimates,17031460500,2688,1008,1680,824,5973,842,5131,13,5871,0,17,72
2014-2018 5-year estimates,17031460500,2718,1188,1530,854,5647,446,5201,34,5580,33,0,0
2006-2010 5-year estimates,17031460400,1716,671,1045,896,3885,544,3341,39,3814,0,0,32
2014-2018 5-year estimates,17031460400,1606,682,924,993,3374,725,2649,64,3286,16,0,8
2006-2010 5-year estimates,17031460302,1756,1060,696,877,4222,1921,2301,48,3970,204,0,0
2014-2018 5-year estimates,17031460302,1631,725,906,850,3483,1320,2163,55,3179,223,0,26
2006-2010 5-year estimates,17031460301,1458,744,714,806,3586,1191,2395,77,2232,1239,0,38
2014-2018 5-year estimates,17031460301,1372,570,802,1015,3124,1062,2062,29,2142,944,0,9
2006-2010 5-year estimates,17031460200,1207,538,669,674,2622,794,1828,362,823,1437,0,0
2014-2018 5-year estimates,17031460200,1155,481,674,761,2482,980,1502,265,898,1319,0,0
2006-2010 5-year estimates,17031460100,1899,1104,795,746,3381,869,2512,47,2727,571,0,36
2014-2018 5-year estimates,17031460100,1776,719,1057,1056,3424,1284,2140,35,2849,443,62,35
2006-2010 5-year estimates,17031450300,1629,515,1114,861,3544,631,2913,151,3311,20,0,62
2014-2018 5-year estimates,17031450300,1637,487,1150,975,3781,544,3237,16,3654,0,0,111
2006-2010 5-year estimates,17031440900,1349,461,888,790,3209,286,2923,20,3123,21,0,45
2014-2018 5-year estimates,17031440900,1168,579,589,897,2547,596,1951,2,2515,0,0,30
2006-2010 5-year estimates,17031440800,930,703,227,738,1954,711,1243,17,1925,0,0,12
2014-2018 5-year estimates,17031440800,879,560,319,877,1693,713,980,22,1658,0,13,0
2006-2010 5-year estimates,17031440700,701,206,495,810,1893,362,1531,28,1810,0,0,55
2014-2018 5-year estimates,17031440700,688,200,488,897,1440,144,1296,38,1397,0,0,5
2006-2010 5-year estimates,17031440600,992,97,895,781,2567,244,2323,0,2557,0,0,10
2014-2018 5-year estimates,17031440600,851,113,738,1618,1807,175,1632,0,1799,8,0,0
2006-2010 5-year estimates,17031440300,2428,1037,1391,824,5072,664,4408,17,4854,0,80,121
2014-2018 5-year estimates,17031440300,2375,954,1421,982,4577,746,3831,31,4457,0,0,89
2006-2010 5-year estimates,17031440202,2115,1301,814,725,3313,679,2634,0,3227,15,0,71
2014-2018 5-year estimates,17031440202,1792,1016,776,792,3213,781,2432,14,3087,77,35,0
2006-2010 5-year estimates,17031440201,3042,2274,768,823,5602,1675,3927,0,5415,12,0,175
2014-2018 5-year estimates,17031440201,2952,2031,921,868,4890,1584,3306,147,4524,113,0,106
2006-2010 5-year estimates,17031440102,2146,1796,350,769,3402,1204,2198,20,3364,0,0,18
2014-2018 5-year estimates,17031440102,2032,1522,510,861,3266,1065,2201,264,2874,82,0,46
2006-2010 5-year estimates,17031440101,2495,1836,659,743,4245,1690,2555,10,4161,40,28,6
2014-2018 5-year estimates,17031440101,2449,1942,507,827,4105,1630,2475,66,3886,95,58,0
2006-2010 5-year estimates,17031431400,4372,3291,1081,739,6099,2019,4080,77,5787,65,36,134
2014-2018 5-year estimates,17031431400,4156,3038,1118,857,6979,2778,4201,494,6181,79,21,204
2006-2010 5-year estimates,17031431302,2463,1700,763,875,3596,1359,2237,0,3568,0,0,28
2014-2018 5-year estimates,17031431302,2330,1397,933,914,4204,1581,2623,12,4023,161,0,8
2006-2010 5-year estimates,17031431301,2056,1678,378,838,3129,1220,1909,16,3036,21,0,56
2014-2018 5-year estimates,17031431301,1852,1051,801,840,3580,1253,2327,75,3304,177,0,24
2006-2010 5-year estimates,17031431200,1320,466,854,776,2842,324,2518,33,2725,40,0,44
2014-2018 5-year estimates,17031431200,1308,424,884,1216,2828,656,2172,32,2708,9,0,79
2006-2010 5-year estimates,17031430900,801,538,263,767,1428,276,1152,0,1428,0,0,0
2014-2018 5-year estimates,17031430900,812,519,293,894,1572,443,1129,1,1558,0,1,12
2006-2010 5-year estimates,17031430800,915,493,422,904,2180,732,1448,21,2127,10,0,22
2014-2018 5-year estimates,17031430800,911,485,426,1173,1756,474,1282,57,1650,29,0,20
2006-2010 5-year estimates,17031430700,1377,1042,335,785,2386,1007,1379,31,2256,51,0,48
2014-2018 5-year estimates,17031430700,1404,1192,212,915,2474,1113,1361,150,2195,34,29,66
2006-2010 5-year estimates,17031430600,964,519,445,819,1544,367,1177,28,1492,24,0,0
2014-2018 5-year estimates,17031430600,883,571,312,748,1920,348,1572,83,1759,38,1,39
2006-2010 5-year estimates,17031430500,2437,2132,305,672,3583,1637,1946,0,3529,0,0,54
2014-2018 5-year estimates,17031430500,2198,1807,391,875,3569,2091,1478,40,3428,67,0,34
2006-2010 5-year estimates,17031430400,1429,710,719,964,2959,592,2367,32,2908,0,0,19
2014-2018 5-year estimates,17031430400,1430,938,492,946,2756,1080,1676,86,2646,0,0,24
2006-2010 5-year estimates,17031430300,1205,825,380,888,2250,781,1469,0,2214,28,0,8
2014-2018 5-year estimates,17031430300,1267,906,361,975,2398,1384,1014,18,2340,32,7,1
2006-2010 5-year estimates,17031430200,2923,2289,634,655,4834,1982,2852,124,4401,151,0,158
2014-2018 5-year estimates,17031430200,2556,2179,377,849,4961,1617,3344,141,4477,279,0,64
2006-2010 5-year estimates,17031430102,2167,1743,424,724,3132,849,2283,24,3085,0,0,23
2014-2018 5-year estimates,17031430102,2017,1790,227,741,3046,829,2217,52,2790,96,28,80
2006-2010 5-year estimates,17031430101,2185,1764,421,829,4296,1581,2715,78,4182,0,0,36
2014-2018 5-year estimates,17031430101,2261,1701,560,940,3118,1116,2002,47,2990,81,0,0
2006-2010 5-year estimates,17031421200,834,467,367,840,1486,538,948,0,1486,0,0,0
2014-2018 5-year estimates,17031421200,779,395,384,483,1210,518,692,0,1171,14,0,25
2006-2010 5-year estimates,17031420800,1089,706,383,825,2274,882,1392,51,2139,69,0,15
2014-2018 5-year estimates,17031420800,1114,695,419,1157,2158,563,1595,46,1946,92,24,50
2006-2010 5-year estimates,17031420700,1930,1047,883,906,3113,1217,1896,0,3082,31,0,0
2014-2018 5-year estimates,17031420700,1782,1098,684,1037,3036,1679,1357,27,2902,45,0,62
2006-2010 5-year estimates,17031420600,1130,749,381,823,1667,530,1137,18,1617,15,0,17
2014-2018 5-year estimates,17031420600,1189,898,291,894,2097,1017,1080,89,1861,76,0,71
2006-2010 5-year estimates,17031420500,1634,1247,387,684,2303,875,1428,0,2277,16,0,10
2014-2018 5-year estimates,17031420500,1136,770,366,939,1659,327,1332,0,1521,99,22,17
2006-2010 5-year estimates,17031420400,892,674,218,685,1516,411,1105,141,1099,41,169,66
2014-2018 5-year estimates,17031420400,789,652,137,771,1131,577,554,210,658,69,169,25
2006-2010 5-year estimates,17031420300,767,450,317,797,1739,468,1271,380,1205,69,85,0
2014-2018 5-year estimates,17031420300,796,581,215,949,2737,991,1746,914,1126,188,488,21
2006-2010 5-year estimates,17031420200,753,492,261,812,1860,482,1378,582,1056,70,62,90
2014-2018 5-year estimates,17031420200,727,494,233,976,1672,617,1055,355,1156,46,94,21
2006-2010 5-year estimates,17031420100,830,747,83,676,1261,409,852,51,1180,20,10,0
2014-2018 5-year estimates,17031420100,802,765,37,787,1447,561,886,53,1243,30,35,86
2006-2010 5-year estimates,17031411200,842,425,417,1032,1582,191,1391,1072,227,52,211,20
2014-2018 5-year estimates,17031411200,807,385,422,1310,1551,310,1241,956,152,73,287,83
2006-2010 5-year estimates,17031411100,1029,474,555,990,2120,343,1777,1600,35,41,436,8
2014-2018 5-year estimates,17031411100,956,450,506,1360,2295,298,1997,1572,114,131,381,97
2006-2010 5-year estimates,17031411000,2253,1386,867,942,3740,808,2932,2235,959,177,296,73
2014-2018 5-year estimates,17031411000,2153,1145,1008,1154,3169,298,2871,1431,1218,170,204,146
2006-2010 5-year estimates,17031410900,2070,1027,1043,801,3830,571,3259,1749,1441,371,240,29
2014-2018 5-year estimates,17031410900,1942,1151,791,1141,3369,714,2655,1650,849,379,334,157
2006-2010 5-year estimates,17031410800,1879,1244,635,723,2610,386,2224,958,1103,139,365,45
2014-2018 5-year estimates,17031410800,1864,1424,440,1022,3051,656,2395,1190,889,279,506,187
2006-2010 5-year estimates,17031410700,1129,729,400,892,2023,593,1430,990,426,254,313,40
2014-2018 5-year estimates,17031410700,1153,755,398,1154,2089,654,1435,1253,359,186,216,75
2006-2010 5-year estimates,17031410600,1163,751,412,1017,2153,418,1735,972,817,90,228,46
2014-2018 5-year estimates,17031410600,1191,744,447,1343,2699,826,1873,1035,883,267,317,197
2006-2010 5-year estimates,17031410500,1517,898,619,875,2583,677,1906,606,1616,160,174,27
2014-2018 5-year estimates,17031410500,1427,1002,425,1272,2440,832,1608,946,959,146,266,123
2006-2010 5-year estimates,17031410200,802,627,175,801,1089,331,758,460,375,12,174,68
2014-2018 5-year estimates,17031410200,726,647,79,1072,1586,479,1107,646,352,221,316,51
2006-2010 5-year estimates,17031410100,1269,940,329,894,1716,402,1314,438,828,327,84,39
2014-2018 5-year estimates,17031410100,1375,1104,271,1202,2176,459,1717,769,801,325,158,123
2006-2010 5-year estimates,17031400800,1311,878,433,690,2006,1133,873,0,1997,0,0,9
2014-2018 5-year estimates,17031400800,1411,1258,153,913,2706,1239,1467,19,2407,42,0,238
2006-2010 5-year estimates,17031400500,1085,784,301,849,2059,787,1272,9,2024,0,0,26
2014-2018 5-year estimates,17031400500,1053,827,226,916,1797,501,1296,4,1754,12,0,27
2006-2010 5-year estimates,17031400400,910,521,389,854,1569,741,828,7,1514,30,9,9
2014-2018 5-year estimates,17031400400,981,723,258,1037,2120,647,1473,18,2086,0,0,16
2006-2010 5-year estimates,17031400300,721,448,273,895,1500,464,1036,0,1500,0,0,0
2014-2018 5-year estimates,17031400300,720,545,175,1125,1317,540,777,30,1168,87,13,19
2006-2010 5-year estimates,17031390700,3894,2503,1391,1126,5426,1156,4270,1516,2695,225,850,140
2014-2018 5-year estimates,17031390700,3820,2444,1376,1404,5639,992,4647,996,3390,133,925,195
2006-2010 5-year estimates,17031390600,976,498,478,901,2043,168,1875,731,968,50,140,154
2014-2018 5-year estimates,17031390600,929,508,421,978,1756,228,1528,829,715,41,63,108
2006-2010 5-year estimates,17031390500,869,528,341,814,1458,241,1217,364,913,78,91,12
2014-2018 5-year estimates,17031390500,889,633,256,1154,1496,298,1198,365,838,129,144,20
2006-2010 5-year estimates,17031390400,1811,1164,647,703,3199,1260,1939,143,2977,31,8,40
2014-2018 5-year estimates,17031390400,1710,1269,441,803,2480,717,1763,295,2082,49,11,43
2006-2010 5-year estimates,17031390300,1556,1146,410,578,2661,1179,1482,53,2549,5,0,54
2014-2018 5-year estimates,17031390300,1665,1417,248,743,2843,1089,1754,359,2337,60,22,65
2006-2010 5-year estimates,17031390200,981,318,663,863,1848,261,1587,63,1550,0,221,14
2014-2018 5-year estimates,17031390200,914,308,606,1134,1656,124,1532,302,1092,29,115,118
2006-2010 5-year estimates,17031390100,674,335,339,717,1401,221,1180,41,1329,8,8,15
2014-2018 5-year estimates,17031390100,684,420,264,1078,1570,195,1375,39,1290,9,106,126
2006-2010 5-year estimates,17031381900,657,405,252,922,1443,351,1092,17,1397,0,0,29
2014-2018 5-year estimates,17031381900,662,383,279,819,1267,266,1001,31,1116,44,5,71
2006-2010 5-year estimates,17031381800,728,430,298,637,894,297,597,28,821,16,0,29
2014-2018 5-year estimates,17031381800,736,471,265,1076,1254,293,961,95,1130,0,29,0
2006-2010 5-year estimates,17031381700,0,0,0,0,0,0,0,0,0,0,0,0
2014-2018 5-year estimates,17031381700,0,0,0,0,0,0,0,0,0,0,0,0
2006-2010 5-year estimates,17031381500,310,180,130,1052,427,0,427,0,427,0,0,0
2014-2018 5-year estimates,17031381500,273,142,131,847,375,185,190,13,346,11,5,0
2006-2010 5-year estimates,17031381400,850,386,464,964,1754,719,1035,39,1627,88,0,0
2014-2018 5-year estimates,17031381400,823,638,185,1005,1586,236,1350,7,1516,0,63,0
2006-2010 5-year estimates,17031381200,1178,818,360,708,2101,330,1771,153,1875,7,22,44
2014-2018 5-year estimates,17031381200,1160,767,393,829,1724,390,1334,63,1487,14,0,160
2006-2010 5-year estimates,17031380700,572,431,141,949,1326,538,788,138,1146,23,10,9
2014-2018 5-year estimates,17031380700,596,455,141,891,1275,275,1000,90,1123,31,0,31
2006-2010 5-year estimates,17031380500,107,86,21,348,302,170,132,0,302,0,0,0
2014-2018 5-year estimates,17031380500,346,338,8,900,866,431,435,0,858,4,4,0
2006-2010 5-year estimates,17031380200,1210,1038,172,566,1692,587,1105,12,1653,8,0,19
2014-2018 5-year estimates,17031380200,1280,1007,273,694,1703,579,1124,19,1630,24,9,21
2006-2010 5-year estimates,17031380100,1231,847,384,442,2248,776,1472,73,2167,0,0,8
2014-2018 5-year estimates,17031380100,1235,898,337,453,1983,781,1202,53,1871,14,0,45
2006-2010 5-year estimates,17031360200,420,368,52,709,951,504,447,0,886,29,0,36
2014-2018 5-year estimates,17031360200,759,718,41,898,1503,407,1096,10,1455,38,0,0
2006-2010 5-year estimates,17031351500,77,68,9,869,73,22,51,0,56,0,17,0
2014-2018 5-year estimates,17031351500,339,306,33,888,773,353,420,176,318,52,203,24
2006-2010 5-year estimates,17031351400,828,736,92,479,1424,638,786,28,1291,105,0,0
2014-2018 5-year estimates,17031351400,842,704,138,346,1836,1155,681,59,1684,32,49,12
2006-2010 5-year estimates,17031351100,1073,940,133,417,2304,1272,1032,0,2304,0,0,0
2014-2018 5-year estimates,17031351100,959,901,58,357,2213,1706,507,52,2111,18,0,32
2006-2010 5-year estimates,17031351000,2481,2106,375,989,3492,810,2682,123,2708,24,585,52
2014-2018 5-year estimates,17031351000,2459,2163,296,1145,3711,1106,2605,170,2762,15,615,149
2006-2010 5-year estimates,17031350400,726,376,350,247,527,328,199,0,527,0,0,0
2014-2018 5-year estimates,17031350400,698,681,17,280,2021,1241,780,32,1985,4,0,0
2006-2010 5-year estimates,17031350100,1712,1689,23,970,2267,324,1943,224,1403,62,496,82
2014-2018 5-year estimates,17031350100,1688,1657,31,1144,2251,700,1551,133,953,83,964,118
2006-2010 5-year estimates,17031340600,502,419,83,357,1023,663,360,0,1023,0,0,0
2014-2018 5-year estimates,17031340600,457,444,13,289,1067,659,408,0,1033,2,0,32
2006-2010 5-year estimates,17031340500,923,740,183,313,1634,526,1108,717,218,229,397,73
2014-2018 5-year estimates,17031340500,917,670,247,763,1712,582,1130,790,37,238,635,12
2006-2010 5-year estimates,17031340400,689,355,334,860,1910,317,1593,329,0,153,1271,157
2014-2018 5-year estimates,17031340400,755,446,309,899,2031,577,1454,207,39,69,1716,0
2006-2010 5-year estimates,17031340300,781,499,282,595,2058,521,1537,291,0,190,1467,110
2014-2018 5-year estimates,17031340300,767,385,382,641,1837,623,1214,328,24,94,1383,8
2006-2010 5-year estimates,17031330200,1993,639,1354,684,3824,268,3556,1626,1245,153,769,31
2014-2018 5-year estimates,17031330200,1954,862,1092,722,3475,483,2992,1557,1066,58,683,111
2006-2010 5-year estimates,17031330100,8951,4278,4673,1268,13117,1338,11779,6086,4291,785,1613,342
2014-2018 5-year estimates,17031330100,12443,5266,7177,1821,19889,1810,18079,9719,4517,897,4114,642
2006-2010 5-year estimates,17031320600,2451,1170,1281,1393,3333,627,2706,1989,521,37,666,120
2014-2018 5-year estimates,17031320600,3279,2059,1220,1905,4923,734,4189,2908,760,288,785,182
2006-2010 5-year estimates,17031320400,321,107,214,1786,558,0,558,369,9,48,109,23
2014-2018 5-year estimates,17031320400,1011,299,712,2314,3204,336,2868,2020,293,246,509,136
2006-2010 5-year estimates,17031320100,6565,3024,3541,1822,7641,611,7030,5449,308,383,1363,138
2014-2018 5-year estimates,17031320100,10016,5074,4942,2300,13379,1003,12376,9095,415,1114,2407,348
2006-2010 5-year estimates,17031310900,1917,1285,632,743,5363,1861,3502,343,73,4827,30,90
2014-2018 5-year estimates,17031310900,1818,1148,670,976,5391,1380,4011,511,31,4738,50,61
2006-2010 5-year estimates,17031310800,1697,967,730,748,4698,1273,3425,477,24,4197,0,0
2014-2018 5-year estimates,17031310800,1670,1166,504,883,4219,451,3768,480,48,3465,164,62
2006-2010 5-year estimates,17031310700,793,463,330,649,1864,979,885,423,60,1371,10,0
2014-2018 5-year estimates,17031310700,598,418,180,864,1460,432,1028,281,46,1036,74,23
2006-2010 5-year estimates,17031310600,2477,1741,736,622,4865,1333,3532,772,334,3512,94,153
2014-2018 5-year estimates,17031310600,2304,1644,660,771,4432,1161,3271,895,215,3159,119,44
2006-2010 5-year estimates,17031310500,636,411,225,713,1646,881,765,68,0,1578,0,0
2014-2018 5-year estimates,17031310500,630,393,237,941,1495,242,1253,283,0,1205,7,0
2006-2010 5-year estimates,17031310400,589,301,288,693,1349,178,1171,163,159,1027,0,0
2014-2018 5-year estimates,17031310400,570,317,253,946,1181,128,1053,299,102,702,58,20
2006-2010 5-year estimates,17031310300,751,469,282,1106,1461,86,1375,461,56,944,0,0
2014-2018 5-year estimates,17031310300,792,525,267,1083,1803,388,1415,480,66,1057,179,21
2006-2010 5-year estimates,17031310200,710,428,282,964,1439,222,1217,496,28,915,0,0
2014-2018 5-year estimates,17031310200,750,418,332,1364,1652,230,1422,590,79,726,208,49
2006-2010 5-year estimates,17031301803,1309,548,761,714,4459,1708,2751,96,0,4361,0,2
2014-2018 5-year estimates,17031301803,1510,870,640,829,5011,1418,3593,151,147,4702,0,11
2006-2010 5-year estimates,17031301802,935,505,430,639,2689,562,2127,110,0,2579,0,0
2014-2018 5-year estimates,17031301802,989,529,460,766,3509,853,2656,54,30,3417,0,8
2006-2010 5-year estimates,17031301801,1110,538,572,801,4178,973,3205,42,76,4040,0,20
2014-2018 5-year estimates,17031301801,1201,694,507,892,3625,837,2788,216,1,3394,0,14
2006-2010 5-year estimates,17031301702,1123,573,550,705,3881,765,3116,54,0,3827,0,0
2014-2018 5-year estimates,17031301702,1146,620,526,802,4387,886,3501,116,0,4239,0,32
2006-2010 5-year estimates,17031301701,1261,611,650,687,4323,1003,3320,50,0,4273,0,0
2014-2018 5-year estimates,17031301701,1251,723,528,777,3943,1388,2555,121,1,3821,0,0
2006-2010 5-year estimates,17031301600,1464,761,703,699,4203,1110,3093,94,0,4109,0,0
2014-2018 5-year estimates,17031301600,1422,696,726,799,4881,1601,3280,120,63,4698,0,0
2006-2010 5-year estimates,17031301200,1381,831,550,793,4323,1487,2836,217,272,3834,0,0
2014-2018 5-year estimates,17031301200,1342,928,414,811,4087,1410,2677,128,271,3639,49,0
2006-2010 5-year estimates,17031301100,807,540,267,662,2414,719,1695,17,83,2314,0,0
2014-2018 5-year estimates,17031301100,882,567,315,712,2423,768,1655,101,171,2125,0,26
2006-2010 5-year estimates,17031300900,1478,798,680,688,3670,1758,1912,187,21,3441,0,21
2014-2018 5-year estimates,17031300900,1527,1169,358,763,4402,1638,2764,240,16,4069,0,77
2006-2010 5-year estimates,17031300800,1372,788,584,740,3934,1589,2345,179,0,3743,0,12
2014-2018 5-year estimates,17031300800,1361,758,603,806,4070,1709,2361,40,0,4030,0,0
2006-2010 5-year estimates,17031300700,1458,887,571,698,4167,1346,2821,111,135,3921,0,0
2014-2018 5-year estimates,17031300700,1541,924,617,841,4721,1544,3177,64,43,4582,32,0
2006-2010 5-year estimates,17031300600,979,529,450,747,3474,792,2682,174,645,2648,0,7
2014-2018 5-year estimates,17031300600,881,421,460,871,3186,787,2399,263,429,2468,0,26
2006-2010 5-year estimates,17031300500,1020,665,355,729,3025,590,2435,0,99,2926,0,0
2014-2018 5-year estimates,17031300500,1047,639,408,839,2889,598,2291,46,174,2660,0,9
2006-2010 5-year estimates,17031292500,1721,808,913,790,3967,1079,2888,28,3908,0,0,31
2014-2018 5-year estimates,17031292500,1667,876,791,992,3897,1079,2818,107,3449,243,0,98
2006-2010 5-year estimates,17031292400,1029,664,365,847,1950,634,1316,73,1854,23,0,0
2014-2018 5-year estimates,17031292400,893,481,412,1066,2203,846,1357,90,2065,47,1,0
2006-2010 5-year estimates,17031292200,1282,716,566,909,3083,1366,1717,114,2921,0,48,0
2014-2018 5-year estimates,17031292200,1159,653,506,1052,2705,1304,1401,117,2261,307,7,13
2006-2010 5-year estimates,17031291600,409,237,172,861,1242,722,520,46,372,809,0,15
2014-2018 5-year estimates,17031291600,385,238,147,944,976,192,784,133,123,720,0,0
2006-2010 5-year estimates,17031291200,974,493,481,901,2179,1344,835,0,2140,0,0,39
2014-2018 5-year estimates,17031291200,947,700,247,1031,2480,1123,1357,45,2383,52,0,0
2006-2010 5-year estimates,17031290900,1827,1097,730,942,4205,1838,2367,0,3934,114,0,157
2014-2018 5-year estimates,17031290900,1738,921,817,848,3746,1652,2094,0,3733,0,13,0
2006-2010 5-year estimates,17031283800,1395,893,502,806,2759,513,2246,649,1637,258,157,58
2014-2018 5-year estimates,17031283800,1742,1035,707,1340,3605,786,2819,1246,1417,501,441,0
2006-2010 5-year estimates,17031283200,579,256,323,959,1034,215,819,291,306,176,218,43
2014-2018 5-year estimates,17031283200,687,413,274,1408,1592,336,1256,639,400,154,352,47
2006-2010 5-year estimates,17031283100,1383,1229,154,1182,2493,995,1498,733,869,146,672,73
2014-2018 5-year estimates,17031283100,1328,1168,160,1488,3257,1163,2094,656,1290,255,972,84
2006-2010 5-year estimates,17031282800,849,490,359,1153,1792,202,1590,888,175,394,286,49
2014-2018 5-year estimates,17031282800,754,475,279,1481,1600,338,1262,459,328,457,311,45
2006-2010 5-year estimates,17031282700,1059,585,474,1298,2367,812,1555,381,881,962,122,21
2014-2018 5-year estimates,17031282700,1022,489,533,1484,2172,482,1690,384,983,499,261,45
2006-2010 5-year estimates,17031281900,3143,2004,1139,1313,3791,538,3253,2093,441,27,1092,138
2014-2018 5-year estimates,17031281900,4018,3008,1010,1812,6018,1077,4941,2410,232,449,2769,158
2006-2010 5-year estimates,17031280900,442,325,117,527,1227,1040,187,0,1227,0,0,0
2014-2018 5-year estimates,17031280900,423,340,83,505,991,558,433,85,865,31,10,0
2006-2010 5-year estimates,17031280800,273,182,91,354,355,142,213,61,294,0,0,0
2014-2018 5-year estimates,17031280800,464,339,125,460,888,269,619,55,798,35,0,0
2006-2010 5-year estimates,17031280400,363,211,152,1093,855,330,525,130,689,16,20,0
2014-2018 5-year estimates,17031280400,593,551,42,1177,1760,648,1112,154,1533,49,13,11
2006-2010 5-year estimates,17031280100,2603,1170,1433,1704,3540,269,3271,2695,70,234,491,50
2014-2018 5-year estimates,17031280100,4554,2818,1736,2212,6447,490,5957,4479,212,287,1199,270
2006-2010 5-year estimates,17031271800,340,154,186,1037,454,89,365,0,454,0,0,0
2014-2018 5-year estimates,17031271800,326,202,124,547,841,607,234,0,841,0,0,0
2006-2010 5-year estimates,17031271500,634,287,347,879,1309,551,758,30,1279,0,0,0
2014-2018 5-year estimates,17031271500,565,338,227,1076,1623,562,1061,88,1465,20,0,50
2006-2010 5-year estimates,17031271400,697,420,277,931,1297,424,873,14,1253,30,0,0
2014-2018 5-year estimates,17031271400,588,421,167,1039,1189,561,628,37,986,23,24,119
2006-2010 5-year estimates,17031271300,478,309,169,901,1195,643,552,16,1166,13,0,0
2014-2018 5-year estimates,17031271300,411,312,99,768,1316,780,536,0,1304,0,12,0
2006-2010 5-year estimates,17031271200,534,369,165,889,1439,532,907,0,1439,0,0,0
2014-2018 5-year estimates,17031271200,483,346,137,1046,1263,474,789,75,1128,12,3,45
2006-2010 5-year estimates,17031270500,769,571,198,669,1597,605,992,48,1450,59,5,35
2014-2018 5-year estimates,17031270500,711,600,111,860,1478,748,730,0,1381,97,0,0
2006-2010 5-year estimates,17031261000,1062,619,443,1030,2486,629,1857,11,2475,0,0,0
2014-2018 5-year estimates,17031261000,930,505,425,999,2321,661,1660,9,2134,115,0,63
2006-2010 5-year estimates,17031260900,626,375,251,1073,1915,686,1229,11,1895,9,0,0
2014-2018 5-year estimates,17031260900,577,271,306,829,1488,457,1031,82,1318,85,0,3
2006-2010 5-year estimates,17031260800,1068,650,418,968,2939,1170,1769,26,2781,113,0,19
2014-2018 5-year estimates,17031260800,1008,734,274,1026,2659,1319,1340,56,2517,11,0,75
2006-2010 5-year estimates,17031260700,857,565,292,1043,2251,801,1450,0,2251,0,0,0
2014-2018 5-year estimates,17031260700,756,432,324,1068,1816,948,868,10,1705,61,0,40
2006-2010 5-year estimates,17031260600,1107,599,508,1055,3083,1505,1578,100,2896,12,0,75
2014-2018 5-year estimates,17031260600,916,412,504,1067,2150,1116,1034,9,2038,48,55,0
2006-2010 5-year estimates,17031260500,816,374,442,1084,1566,642,924,0,1566,0,0,0
2014-2018 5-year estimates,17031260500,713,417,296,1221,1713,843,870,5,1627,72,0,9
2006-2010 5-year estimates,17031260400,582,275,307,727,1092,472,620,7,1076,0,0,9
2014-2018 5-year estimates,17031260400,524,323,201,888,1145,357,788,24,1121,0,0,0
2006-2010 5-year estimates,17031260300,715,448,267,672,1790,831,959,0,1767,23,0,0
2014-2018 5-year estimates,17031260300,647,467,180,881,1430,535,895,22,1408,0,0,0
2006-2010 5-year estimates,17031260200,494,325,169,1109,1004,259,745,0,1004,0,0,0
2014-2018 5-year estimates,17031260200,427,247,180,1116,1067,332,735,0,1024,43,0,0
2006-2010 5-year estimates,17031260100,935,655,280,395,1199,701,498,20,1147,32,0,0
2014-2018 5-year estimates,17031260100,851,565,286,542,1154,586,568,141,989,12,0,12
2006-2010 5-year estimates,17031252202,1999,1294,705,863,4330,1412,2918,30,4288,12,0,0
2014-2018 5-year estimates,17031252202,1854,1290,564,905,4653,1810,2843,58,4432,109,54,0
2006-2010 5-year estimates,17031252201,1061,624,437,871,2988,1383,1605,150,2821,9,8,0
2014-2018 5-year estimates,17031252201,1103,680,423,987,2922,900,2022,140,2707,67,8,0
2006-2010 5-year estimates,17031252102,2549,1507,1042,935,7241,2737,4504,0,7213,0,0,28
2014-2018 5-year estimates,17031252102,2473,1233,1240,1012,7295,2371,4924,115,6902,278,0,0
2006-2010 5-year estimates,17031252101,761,633,128,690,1573,444,1129,163,1376,34,0,0
2014-2018 5-year estimates,17031252101,752,569,183,758,1284,440,844,32,1194,48,0,10
2006-2010 5-year estimates,17031252000,2651,2179,472,700,5361,1828,3533,54,5024,283,0,0
2014-2018 5-year estimates,17031252000,2648,2010,638,845,5556,1861,3695,55,5299,157,0,45
2006-2010 5-year estimates,17031251900,2498,1680,818,786,5369,2464,2905,84,5241,26,18,0
2014-2018 5-year estimates,17031251900,2104,1414,690,863,4466,2166,2300,115,4106,234,0,11
2006-2010 5-year estimates,17031251800,2215,1578,637,928,5618,1949,3669,25,5531,47,0,15
2014-2018 5-year estimates,17031251800,1965,1480,485,938,4943,1770,3173,188,4494,156,0,105
2006-2010 5-year estimates,17031251700,538,260,278,931,1454,632,822,10,1306,127,0,11
2014-2018 5-year estimates,17031251700,478,263,215,1131,1329,256,1073,22,960,347,0,0
2006-2010 5-year estimates,17031251600,1410,705,705,969,3329,1178,2151,0,3294,0,35,0
2014-2018 5-year estimates,17031251600,1319,703,616,1096,4161,1356,2805,70,3490,445,0,156
2006-2010 5-year estimates,17031251500,1714,1045,669,835,4605,1455,3150,108,4477,20,0,0
2014-2018 5-year estimates,17031251500,1681,1146,535,976,4176,1896,2280,47,3789,324,0,16
2006-2010 5-year estimates,17031251400,1960,1309,651,766,4161,1215,2946,234,3702,186,30,9
2014-2018 5-year estimates,17031251400,1874,1325,549,824,3951,865,3086,270,3392,214,0,75
2006-2010 5-year estimates,17031251300,2001,1131,870,933,5204,1150,4054,35,4897,263,0,9
2014-2018 5-year estimates,17031251300,1838,804,1034,1042,3934,921,3013,140,3135,652,0,7
2006-2010 5-year estimates,17031251200,1380,484,896,914,3739,879,2860,19,3331,232,0,157
2014-2018 5-year estimates,17031251200,1326,496,830,1141,4487,1072,3415,65,3250,1103,69,0
2006-2010 5-year estimates,17031251100,1927,1122,805,914,4670,1111,3559,40,4222,253,0,155
2014-2018 5-year estimates,17031251100,1766,1113,653,879,4416,1837,2579,93,3676,647,0,0
2006-2010 5-year estimates,17031251000,455,258,197,828,1190,405,785,0,1122,68,0,0
2014-2018 5-year estimates,17031251000,390,130,260,943,960,183,777,21,758,181,0,0
2006-2010 5-year estimates,17031250800,923,359,564,856,2310,483,1827,24,1960,317,0,9
2014-2018 5-year estimates,17031250800,886,307,579,933,2427,806,1621,14,1984,416,13,0
2006-2010 5-year estimates,17031250700,2420,1510,910,892,6138,1350,4788,0,6026,112,0,0
2014-2018 5-year estimates,17031250700,2382,1257,1125,970,5396,955,4441,0,4307,902,0,187
2006-2010 5-year estimates,17031250600,1527,553,974,920,4921,1038,3883,119,4432,295,0,75
2014-2018 5-year estimates,17031250600,1436,426,1010,1014,4120,630,3490,53,3559,475,33,0
2006-2010 5-year estimates,17031250500,2897,497,2400,923,7307,555,6752,3190,2006,1874,40,197
2014-2018 5-year estimates,17031250500,2958,777,2181,864,7452,864,6588,2667,2361,1921,229,274
2006-2010 5-year estimates,17031250400,2225,1132,1093,883,6580,862,5718,252,5265,1063,0,0
2014-2018 5-year estimates,17031250400,2253,1063,1190,1092,4963,1295,3668,23,3916,973,0,51
2006-2010 5-year estimates,17031250300,1775,903,872,943,3930,1030,2900,0,3360,557,13,0
2014-2018 5-year estimates,17031250300,1803,1040,763,997,5118,1679,3439,40,3370,1602,24,82
2006-2010 5-year estimates,17031250200,982,405,577,909,3068,288,2780,26,1738,1182,37,85
2014-2018 5-year estimates,17031250200,926,361,565,1030,2730,431,2299,40,1433,1213,25,19
2006-2010 5-year estimates,17031243500,1739,872,867,1223,3013,437,2576,2105,381,159,252,116
2014-2018 5-year estimates,17031243500,1982,1022,960,1978,3584,280,3304,2197,799,213,282,93
2006-2010 5-year estimates,17031243400,1426,798,628,971,2556,217,2339,1496,106,772,122,60
2014-2018 5-year estimates,17031243400,1437,702,735,1252,2742,398,2344,1372,185,937,153,95
2006-2010 5-year estimates,17031243300,1313,805,508,1070,2051,273,1778,1308,39,517,100,87
2014-2018 5-year estimates,17031243300,1245,642,603,1438,2375,276,2099,1499,44,675,121,36
2006-2010 5-year estimates,17031243200,1048,516,532,983,1858,65,1793,1157,21,627,45,8
2014-2018 5-year estimates,17031243200,1029,561,468,1554,2206,247,1959,1408,73,657,65,3
2006-2010 5-year estimates,17031243100,994,472,522,1044,1954,162,1792,838,114,960,24,18
2014-2018 5-year estimates,17031243100,1010,412,598,1398,2044,147,1897,1377,49,410,151,57
2006-2010 5-year estimates,17031243000,1185,486,699,1179,2385,372,2013,1137,33,1139,66,10
2014-2018 5-year estimates,17031243000,1073,672,401,1333,2274,161,2113,1270,78,797,93,36
2006-2010 5-year estimates,17031242900,964,569,395,992,2209,517,1692,1244,53,822,79,11
2014-2018 5-year estimates,17031242900,889,508,381,1361,1617,55,1562,1112,84,294,88,39
2006-2010 5-year estimates,17031242800,717,241,476,1132,1752,86,1666,1338,8,406,0,0
2014-2018 5-year estimates,17031242800,639,241,398,1500,1542,86,1456,1173,14,318,10,27
2006-2010 5-year estimates,17031242700,823,623,200,906,2081,822,1259,270,486,1243,74,8
2014-2018 5-year estimates,17031242700,787,578,209,1044,1669,344,1325,553,408,638,50,20
2006-2010 5-year estimates,17031242600,2759,1514,1245,921,4659,1314,3345,2204,565,1879,11,0
2014-2018 5-year estimates,17031242600,2865,1877,988,1126,5752,995,4757,2816,797,2003,98,38
2006-2010 5-year estimates,17031242500,1634,1075,559,1061,3913,892,3021,1814,201,1701,197,0
2014-2018 5-year estimates,17031242500,1666,1076,590,1281,3282,469,2813,2012,249,737,93,191
2006-2010 5-year estimates,17031242400,1614,1099,515,989,2772,175,2597,2280,84,346,30,32
2014-2018 5-year estimates,17031242400,1546,1056,490,1475,2679,289,2390,2419,46,115,42,57
2006-2010 5-year estimates,17031242300,1866,1094,772,1095,3604,393,3211,2874,45,581,69,35
2014-2018 5-year estimates,17031242300,1743,948,795,1523,3306,182,3124,2650,61,330,176,89
2006-2010 5-year estimates,17031242200,2014,1083,931,1220,3892,510,3382,2885,149,613,193,52
2014-2018 5-year estimates,17031242200,1883,1094,789,1660,3347,204,3143,2598,95,406,120,128
2006-2010 5-year estimates,17031242100,1867,841,1026,1136,3448,431,3017,2377,134,751,97,89
2014-2018 5-year estimates,17031242100,1742,874,868,1726,3878,314,3564,2712,41,751,213,161
2006-2010 5-year estimates,17031242000,2424,1712,712,860,4557,1021,3536,2021,742,1652,40,102
2014-2018 5-year estimates,17031242000,2244,1698,546,1216,5254,919,4335,2797,712,1242,395,108
2006-2010 5-year estimates,17031241600,1796,1227,569,1034,3729,664,3065,2354,151,903,230,91
2014-2018 5-year estimates,17031241600,1715,1211,504,1617,3603,414,3189,2197,122,934,272,78
2006-2010 5-year estimates,17031241500,1540,751,789,1378,3075,510,2565,1991,91,689,94,210
2014-2018 5-year estimates,17031241500,1353,782,571,1704,2930,378,2552,2126,72,495,131,106
2006-2010 5-year estimates,17031241400,2523,1425,1098,1141,4644,697,3947,3424,406,727,87,0
2014-2018 5-year estimates,17031241400,2570,1728,842,2003,5230,549,4681,3918,251,632,276,153
2006-2010 5-year estimates,17031241300,864,463,401,1544,1987,356,1631,1288,431,183,69,16
2014-2018 5-year estimates,17031241300,811,394,417,2124,2090,307,1783,1399,198,377,37,79
2006-2010 5-year estimates,17031241200,896,535,361,1259,2002,352,1650,1201,157,524,116,4
2014-2018 5-year estimates,17031241200,825,506,319,1585,1797,131,1666,1102,46,395,181,73
2006-2010 5-year estimates,17031241100,1818,1106,712,1032,3767,964,2803,1293,706,1718,50,0
2014-2018 5-year estimates,17031241100,1646,1130,516,1380,3826,895,2931,1851,376,1280,143,176
2006-2010 5-year estimates,17031241000,958,599,359,799,2423,1122,1301,354,919,1150,0,0
2014-2018 5-year estimates,17031241000,873,601,272,1198,2096,597,1499,756,267,987,68,18
2006-2010 5-year estimates,17031240900,581,332,249,935,1098,357,741,323,242,494,29,10
2014-2018 5-year estimates,17031240900,574,438,136,1076,928,268,660,294,83,422,79,50
2006-2010 5-year estimates,17031240800,793,519,274,821,1880,391,1489,515,137,1107,56,65
2014-2018 5-year estimates,17031240800,708,419,289,1019,1500,332,1168,527,74,805,27,67
2006-2010 5-year estimates,17031240700,634,330,304,831,1786,552,1234,325,66,1259,136,0
2014-2018 5-year estimates,17031240700,680,426,254,1150,1752,406,1346,612,130,906,64,40
2006-2010 5-year estimates,17031240600,654,236,418,1244,1347,303,1044,618,48,634,47,0
2014-2018 5-year estimates,17031240600,638,307,331,1582,1506,123,1383,911,78,456,19,42
2006-2010 5-year estimates,17031240500,1201,505,696,1592,2338,180,2158,1718,326,138,132,24
2014-2018 5-year estimates,17031240500,1284,381,903,2124,2267,61,2206,1832,45,142,194,54
2006-2010 5-year estimates,17031240300,773,329,444,929,1424,74,1350,1126,0,201,48,49
2014-2018 5-year estimates,17031240300,677,299,378,1750,1215,56,1159,979,53,54,78,51
2006-2010 5-year estimates,17031240200,917,439,478,966,1527,137,1390,1054,21,368,61,23
2014-2018 5-year estimates,17031240200,814,374,440,1508,1641,113,1528,1234,27,237,83,60
2006-2010 5-year estimates,17031231500,2572,1541,1031,819,5286,2173,3113,117,5034,123,0,12
2014-2018 5-year estimates,17031231500,2318,1304,1014,945,5772,2165,3607,154,4717,872,0,29
2006-2010 5-year estimates,17031231200,2419,1407,1012,930,6618,2660,3958,164,5287,1155,0,12
2014-2018 5-year estimates,17031231200,2253,1414,839,986,6782,2102,4680,51,3873,2652,0,206
2006-2010 5-year estimates,17031231100,425,308,117,1063,1216,289,927,0,769,266,0,181
2014-2018 5-year estimates,17031231100,400,220,180,840,1292,380,912,39,717,520,0,16
2006-2010 5-year estimates,17031230900,2181,1308,873,944,5416,1847,3569,807,996,3472,39,102
2014-2018 5-year estimates,17031230900,2070,1331,739,1094,4965,1643,3322,978,836,2818,108,225
2006-2010 5-year estimates,17031230800,454,97,357,1063,1381,70,1311,26,0,1279,21,55
2014-2018 5-year estimates,17031230800,407,180,227,944,1425,316,1109,119,47,1259,0,0
2006-2010 5-year estimates,17031230700,2140,1155,985,911,6062,1485,4577,230,1021,4811,0,0
2014-2018 5-year estimates,17031230700,1974,999,975,1063,5899,1209,4690,430,345,5081,0,43
2006-2010 5-year estimates,17031230600,2302,1557,745,950,6938,1637,5301,26,1925,4858,88,41
2014-2018 5-year estimates,17031230600,2162,1461,701,982,7303,1884,5419,137,1590,5285,0,291
2006-2010 5-year estimates,17031230500,1154,881,273,854,3483,1083,2400,233,386,2843,21,0
2014-2018 5-year estimates,17031230500,1248,940,308,837,3489,1204,2285,67,334,2934,154,0
2006-2010 5-year estimates,17031230400,849,452,397,884,2618,639,1979,102,119,2370,0,27
2014-2018 5-year estimates,17031230400,765,341,424,1106,2089,441,1648,234,0,1799,29,27
2006-2010 5-year estimates,17031230300,302,149,153,900,841,151,690,24,0,817,0,0
2014-2018 5-year estimates,17031230300,320,205,115,923,1001,193,808,101,7,813,0,80
2006-2010 5-year estimates,17031230200,709,382,327,952,1375,381,994,119,195,950,0,111
2014-2018 5-year estimates,17031230200,689,422,267,1099,2149,445,1704,339,321,1421,43,25
2006-2010 5-year estimates,17031230100,721,474,247,914,1594,457,1137,276,364,946,8,0
2014-2018 5-year estimates,17031230100,675,439,236,1064,1794,454,1340,574,288,847,69,16
2006-2010 5-year estimates,17031222900,434,178,256,833,1585,521,1064,128,223,1201,33,0
2014-2018 5-year estimates,17031222900,412,168,244,1166,1051,124,927,185,88,771,0,7
2006-2010 5-year estimates,17031222800,423,336,87,735,744,266,478,0,138,606,0,0
2014-2018 5-year estimates,17031222800,413,281,132,986,968,230,738,210,40,714,0,4
2006-2010 5-year estimates,17031222700,938,481,457,882,3027,875,2152,388,366,2259,0,14
2014-2018 5-year estimates,17031222700,918,618,300,1177,2462,487,1975,776,189,1403,30,64
2006-2010 5-year estimates,17031222600,781,577,204,774,1533,274,1259,705,181,528,99,20
2014-2018 5-year estimates,17031222600,778,466,312,1243,1573,113,1460,892,68,549,25,39
2006-2010 5-year estimates,17031222500,649,360,289,992,1557,199,1358,362,133,1055,0,7
2014-2018 5-year estimates,17031222500,557,351,206,1225,1748,395,1353,650,63,993,11,31
2006-2010 5-year estimates,17031222200,969,439,530,1187,1926,119,1807,1446,50,252,168,10
2014-2018 5-year estimates,17031222200,953,455,498,1956,2226,136,2090,1587,110,277,154,98
2006-2010 5-year estimates,17031221600,1522,817,705,1131,2692,369,2323,1793,5,677,129,88
2014-2018 5-year estimates,17031221600,1530,707,823,1714,3136,176,2960,2263,99,526,141,107
2006-2010 5-year estimates,17031221500,1542,1115,427,821,3036,519,2517,1185,106,1538,127,80
2014-2018 5-year estimates,17031221500,1500,912,588,1104,2822,282,2540,1738,152,687,199,46
2006-2010 5-year estimates,17031221400,1266,827,439,1064,2928,685,2243,606,81,2203,38,0
2014-2018 5-year estimates,17031221400,1479,855,624,1459,3026,212,2814,1390,131,1315,100,90
2006-2010 5-year estimates,17031221300,1431,1008,423,806,2835,695,2140,1073,107,1520,98,37
2014-2018 5-year estimates,17031221300,1457,1052,405,1131,2848,627,2221,1496,104,1058,104,86
2006-2010 5-year estimates,17031221200,1196,535,661,998,2124,325,1799,1115,121,785,24,79
2014-2018 5-year estimates,17031221200,1308,813,495,1403,2917,289,2628,1725,142,921,63,66
2006-2010 5-year estimates,17031221100,2180,1616,564,899,5670,1684,3986,1687,588,3080,65,250
2014-2018 5-year estimates,17031221100,2082,1384,698,1152,5207,1062,4145,2027,464,2489,117,110
2006-2010 5-year estimates,17031221000,1152,598,554,948,3021,937,2084,480,345,2157,39,0
2014-2018 5-year estimates,17031221000,1113,702,411,1182,2774,710,2064,748,283,1686,44,13
2006-2010 5-year estimates,17031220902,1138,749,389,881,3174,828,2346,478,516,2127,33,20
2014-2018 5-year estimates,17031220902,1117,591,526,1114,2927,401,2526,495,18,2350,24,40
2006-2010 5-year estimates,17031220901,1223,839,384,852,2920,555,2365,306,311,2198,47,58
2014-2018 5-year estimates,17031220901,1134,672,462,986,3073,836,2237,658,284,2074,26,31
2006-2010 5-year estimates,17031220702,1545,816,729,925,3436,670,2766,800,163,2354,78,41
2014-2018 5-year estimates,17031220702,1572,954,618,1091,3817,527,3290,1060,151,2433,128,45
2006-2010 5-year estimates,17031220701,1292,819,473,852,3791,974,2817,730,277,2724,60,0
2014-2018 5-year estimates,17031220701,1201,679,522,1136,3230,436,2794,744,150,2232,47,57
2006-2010 5-year estimates,17031220602,2742,1694,1048,779,5111,1308,3803,2098,537,1972,415,89
2014-2018 5-year estimates,17031220602,2646,1991,655,1099,5058,865,4193,2455,220,2157,136,90
2006-2010 5-year estimates,17031220601,808,446,362,698,1940,365,1575,569,126,1096,138,11
2014-2018 5-year estimates,17031220601,753,510,243,1396,1763,217,1546,875,56,739,15,78
2006-2010 5-year estimates,17031220500,1301,770,531,1081,2845,489,2356,1568,146,926,172,33
2014-2018 5-year estimates,17031220500,1296,726,570,1602,2607,222,2385,1718,172,521,125,71
2006-2010 5-year estimates,17031220400,1281,716,565,1099,2501,385,2116,1204,129,1006,126,36
2014-2018 5-year estimates,17031220400,1224,638,586,1632,2643,159,2484,1698,15,701,160,69
2006-2010 5-year estimates,17031220300,1058,507,551,955,2676,527,2149,1615,83,900,45,33
2014-2018 5-year estimates,17031220300,967,554,413,1340,2201,236,1965,1365,44,679,57,56
2006-2010 5-year estimates,17031210900,1321,519,802,883,2763,304,2459,1001,66,1486,80,130
2014-2018 5-year estimates,17031210900,1354,742,612,1214,3095,495,2600,1580,70,1260,139,46
2006-2010 5-year estimates,17031210800,476,257,219,963,1297,428,869,407,10,874,0,6
2014-2018 5-year estimates,17031210800,409,247,162,1095,1077,59,1018,503,1,549,14,10
2006-2010 5-year estimates,17031210700,1797,930,867,931,4330,658,3672,1414,228,2635,12,41
2014-2018 5-year estimates,17031210700,1736,991,745,1186,4392,1001,3391,1505,36,2530,147,174
2006-2010 5-year estimates,17031210602,1801,955,846,929,5022,693,4329,862,397,3658,48,57
2014-2018 5-year estimates,17031210602,1763,947,816,1137,4200,634,3566,1313,109,2359,190,229
2006-2010 5-year estimates,17031210601,1073,588,485,938,3175,384,2791,811,0,2144,197,23
2014-2018 5-year estimates,17031210601,1089,566,523,1130,2761,342,2419,836,4,1744,130,47
2006-2010 5-year estimates,17031210502,1687,870,817,848,5076,954,4122,1212,26,3838,0,0
2014-2018 5-year estimates,17031210502,1701,1012,689,1084,4685,1415,3270,1202,126,3158,45,154
2006-2010 5-year estimates,17031210501,1510,904,606,850,4236,1186,3050,1021,57,2982,141,35
2014-2018 5-year estimates,17031210501,1505,1003,502,1042,3273,710,2563,1086,165,1937,16,69
2006-2010 5-year estimates,17031210400,1054,502,552,831,2707,398,2309,668,0,1804,130,105
2014-2018 5-year estimates,17031210400,1111,603,508,1062,2851,673,2178,783,66,1893,44,65
2006-2010 5-year estimates,17031210100,1650,713,937,904,4424,491,3933,1565,168,2370,191,130
2014-2018 5-year estimates,17031210100,1658,768,890,1193,3684,501,3183,1757,140,1366,314,107
2006-2010 5-year estimates,17031200402,1396,793,603,801,3943,726,3217,126,32,3706,14,65
2014-2018 5-year estimates,17031200402,1297,602,695,901,4380,845,3535,164,192,3793,154,77
2006-2010 5-year estimates,17031200401,1111,410,701,1075,3935,712,3223,371,0,3518,46,0
2014-2018 5-year estimates,17031200401,1078,531,547,972,3746,693,3053,304,124,3271,32,15
2006-2010 5-year estimates,17031200300,672,271,401,817,2034,769,1265,241,0,1766,17,10
2014-2018 5-year estimates,17031200300,641,351,290,988,1962,640,1322,136,31,1766,29,0
2006-2010 5-year estimates,17031200200,1818,1043,775,955,5543,643,4900,450,65,4840,188,0
2014-2018 5-year estimates,17031200200,1789,937,852,1039,4800,1027,3773,599,182,3843,73,103
2006-2010 5-year estimates,17031200100,1372,580,792,784,4197,525,3672,781,11,3248,144,13
2014-2018 5-year estimates,17031200100,1401,653,748,980,3763,297,3466,806,91,2666,143,57
2006-2010 5-year estimates,17031191302,1491,703,788,843,4996,1269,3727,489,105,4360,42,0
2014-2018 5-year estimates,17031191302,1538,742,796,1030,5333,757,4576,436,216,4681,0,0
2006-2010 5-year estimates,17031191301,1551,665,886,1000,6462,1506,4956,413,787,5183,79,0
2014-2018 5-year estimates,17031191301,1609,856,753,991,5658,1041,4617,168,179,5034,259,18
2006-2010 5-year estimates,17031191200,1081,696,385,863,3597,1237,2360,455,154,2988,0,0
2014-2018 5-year estimates,17031191200,1130,637,493,987,3934,893,3041,100,31,3802,1,0
2006-2010 5-year estimates,17031191100,2260,1388,872,876,8102,2487,5615,259,996,6348,70,429
2014-2018 5-year estimates,17031191100,2185,928,1257,938,7482,1264,6218,383,262,6594,139,104
2006-2010 5-year estimates,17031191000,723,368,355,846,2371,590,1781,105,50,2216,0,0
2014-2018 5-year estimates,17031191000,778,305,473,972,2651,689,1962,165,32,2314,140,0
2006-2010 5-year estimates,17031190900,644,240,404,746,2072,340,1732,231,280,1518,43,0
2014-2018 5-year estimates,17031190900,714,436,278,943,2537,523,2014,210,72,2255,0,0
2006-2010 5-year estimates,17031190800,2119,953,1166,947,7315,1185,6130,359,372,6424,160,0
2014-2018 5-year estimates,17031190800,2128,1147,981,1057,7338,1394,5944,747,57,6318,54,162
2006-2010 5-year estimates,17031190702,1535,802,733,862,4344,565,3779,822,140,3308,0,74
2014-2018 5-year estimates,17031190702,1606,1022,584,1008,4841,1467,3374,495,225,4112,0,9
2006-2010 5-year estimates,17031190701,911,497,414,960,3192,565,2627,509,128,2484,71,0
2014-2018 5-year estimates,17031190701,901,542,359,987,2924,687,2237,337,15,2496,41,35
2006-2010 5-year estimates,17031190602,1425,545,880,867,5162,681,4481,1171,651,3340,0,0
2014-2018 5-year estimates,17031190602,1579,406,1173,1009,5608,622,4986,719,145,4501,165,78
2006-2010 5-year estimates,17031190601,1313,688,625,1044,4682,1288,3394,756,198,3611,53,64
2014-2018 5-year estimates,17031190601,1360,539,821,1164,5145,823,4322,312,255,4557,21,0
2006-2010 5-year estimates,17031190402,1767,729,1038,849,5392,981,4411,1342,104,3689,210,47
2014-2018 5-year estimates,17031190402,1809,737,1072,1076,5572,407,5165,1469,85,3981,37,0
2006-2010 5-year estimates,17031190401,1307,544,763,879,4354,583,3771,1567,111,2546,90,40
2014-2018 5-year estimates,17031190401,1355,388,967,1167,4193,772,3421,1275,0,2605,295,18
2006-2010 5-year estimates,17031190300,1980,1009,971,771,5347,658,4689,1998,9,3300,40,0
2014-2018 5-year estimates,17031190300,1992,919,1073,855,5535,924,4611,1575,72,3616,37,235
2006-2010 5-year estimates,17031190200,1757,801,956,903,6243,1480,4763,1229,63,4570,118,263
2014-2018 5-year estimates,17031190200,1791,704,1087,1085,5624,669,4955,702,121,4657,77,67
2006-2010 5-year estimates,17031190100,844,545,299,804,2480,444,2036,488,125,1859,0,8
2014-2018 5-year estimates,17031190100,872,605,267,902,2606,597,2009,244,36,2253,63,10
2006-2010 5-year estimates,17031180100,2204,496,1708,1024,6223,554,5669,3538,123,2334,164,64
2014-2018 5-year estimates,17031180100,2364,493,1871,898,6360,1177,5183,2620,51,3207,451,31
2006-2010 5-year estimates,17031171100,1380,262,1118,873,4235,275,3960,2202,58,1604,371,0
2014-2018 5-year estimates,17031171100,1405,300,1105,1068,3841,365,3476,1914,85,1570,247,25
2006-2010 5-year estimates,17031171000,2729,753,1976,866,7148,793,6355,4657,0,2030,415,46
2014-2018 5-year estimates,17031171000,2777,644,2133,1036,7328,638,6690,4395,533,1926,403,71
2006-2010 5-year estimates,17031170900,648,166,482,984,1784,43,1741,1253,113,185,221,12
2014-2018 5-year estimates,17031170900,677,196,481,1000,1881,126,1755,951,79,797,54,0
2006-2010 5-year estimates,17031170800,1446,258,1188,814,3682,490,3192,2832,0,770,80,0
2014-2018 5-year estimates,17031170800,1516,372,1144,1085,4189,268,3921,2639,35,1324,174,17
2006-2010 5-year estimates,17031170700,1199,384,815,841,3139,166,2973,2553,0,449,85,52
2014-2018 5-year estimates,17031170700,1229,217,1012,1083,3177,267,2910,2145,7,727,298,0
2006-2010 5-year estimates,17031170600,971,199,772,897,2774,211,2563,2260,0,168,346,0
2014-2018 5-year estimates,17031170600,1001,156,845,1098,2468,118,2350,1895,15,409,92,57
2006-2010 5-year estimates,17031170500,1971,366,1605,1056,4543,82,4461,3555,0,925,12,51
2014-2018 5-year estimates,17031170500,2078,468,1610,1148,5593,330,5263,3832,0,1319,383,59
2006-2010 5-year estimates,17031170400,1466,171,1295,741,3898,249,3649,3079,30,549,121,119
2014-2018 5-year estimates,17031170400,1584,437,1147,1145,4044,481,3563,2696,75,1044,208,21
2006-2010 5-year estimates,17031170300,1981,500,1481,957,5451,736,4715,4008,41,1033,272,97
2014-2018 5-year estimates,17031170300,1997,732,1265,1009,5350,449,4901,2973,3,2106,268,0
2006-2010 5-year estimates,17031170200,1280,185,1095,936,3543,117,3426,2393,0,910,210,30
2014-2018 5-year estimates,17031170200,1310,226,1084,1112,4106,333,3773,2131,0,1659,316,0
2006-2010 5-year estimates,17031170100,1094,185,909,1207,2447,100,2347,1709,276,387,75,0
2014-2018 5-year estimates,17031170100,1136,340,796,1435,2058,212,1846,1588,157,223,90,0
2006-2010 5-year estimates,17031161300,1647,1098,549,852,4146,439,3707,1625,62,2353,95,11
2014-2018 5-year estimates,17031161300,1645,1034,611,966,3919,317,3602,1341,110,2303,82,83
2006-2010 5-year estimates,17031161200,1090,362,728,954,2758,141,2617,934,24,1459,341,0
2014-2018 5-year estimates,17031161200,1059,408,651,1080,3090,365,2725,910,21,1963,145,51
2006-2010 5-year estimates,17031161100,805,179,626,1055,2000,158,1842,1530,54,136,235,45
2014-2018 5-year estimates,17031161100,838,228,610,1354,2043,43,2000,1293,138,325,172,115
2006-2010 5-year estimates,17031161000,890,345,545,965,1799,117,1682,1438,0,270,63,28
2014-2018 5-year estimates,17031161000,916,387,529,1183,2151,138,2013,1271,53,757,34,36
2006-2010 5-year estimates,17031160900,1136,466,670,866,2618,152,2466,1554,0,890,174,0
2014-2018 5-year estimates,17031160900,1121,548,573,1099,2464,232,2232,1285,48,777,249,105
2006-2010 5-year estimates,17031160800,2072,1148,924,967,5152,495,4657,1499,59,2916,446,232
2014-2018 5-year estimates,17031160800,2057,1124,933,1123,4909,368,4541,1630,80,2552,537,110
2006-2010 5-year estimates,17031160700,2207,855,1352,984,6068,407,5661,2553,254,2693,550,18
2014-2018 5-year estimates,17031160700,2499,1251,1248,1266,6191,904,5287,2696,205,2561,645,84
2006-2010 5-year estimates,17031160602,1607,801,806,910,3520,496,3024,1184,106,1919,294,17
2014-2018 5-year estimates,17031160602,1627,876,751,1028,3681,217,3464,1392,109,1593,382,205
2006-2010 5-year estimates,17031160601,1487,833,654,1053,2906,305,2601,1467,60,1040,266,73
2014-2018 5-year estimates,17031160601,1465,738,727,1211,3529,353,3176,1685,62,1514,170,98
2006-2010 5-year estimates,17031160502,1431,589,842,913,4496,481,4015,1193,33,2744,483,43
2014-2018 5-year estimates,17031160502,1469,811,658,1118,3782,442,3340,907,17,2610,163,85
2006-2010 5-year estimates,17031160501,1481,835,646,925,3685,899,2786,829,334,2397,105,20
2014-2018 5-year estimates,17031160501,1532,784,748,1119,3870,546,3324,942,243,2075,493,117
2006-2010 5-year estimates,17031160400,2058,1132,926,895,5375,833,4542,2062,335,2366,315,297
2014-2018 5-year estimates,17031160400,2103,1085,1018,1062,4693,695,3998,2207,217,1791,286,192
2006-2010 5-year estimates,17031160300,2018,1159,859,787,4218,709,3509,2037,530,1110,488,53
2014-2018 5-year estimates,17031160300,2045,1035,1010,959,3764,455,3309,2233,288,566,402,275
2006-2010 5-year estimates,17031160200,1470,533,937,907,3750,311,3439,2340,87,964,261,98
2014-2018 5-year estimates,17031160200,1347,420,927,961,3002,207,2795,1902,27,648,301,124
2006-2010 5-year estimates,17031160100,1066,239,827,1009,2362,184,2178,1616,0,632,78,36
2014-2018 5-year estimates,17031160100,1053,468,585,1150,2577,242,2335,1346,15,608,356,252
2006-2010 5-year estimates,17031151200,1306,359,947,832,3649,252,3397,2296,132,1006,215,0
2014-2018 5-year estimates,17031151200,1347,340,1007,948,3474,337,3137,1646,24,1711,70,23
2006-2010 5-year estimates,17031151100,1889,986,903,846,4750,708,4042,2155,32,2363,141,59
2014-2018 5-year estimates,17031151100,1877,973,904,1038,5325,937,4388,1942,25,2940,383,35
2006-2010 5-year estimates,17031151002,1838,1145,693,783,5001,865,4136,1400,89,3185,155,172
2014-2018 5-year estimates,17031151002,1705,874,831,1048,4770,482,4288,1158,59,3320,98,135
2006-2010 5-year estimates,17031151001,1021,412,609,996,3162,512,2650,611,34,2453,0,64
2014-2018 5-year estimates,17031151001,1050,438,612,1021,2714,470,2244,794,45,1731,136,8
2006-2010 5-year estimates,17031150800,1952,895,1057,864,5299,843,4456,2152,0,2746,345,56
2014-2018 5-year estimates,17031150800,1841,877,964,1044,4967,248,4719,1975,24,2335,401,232
2006-2010 5-year estimates,17031150700,1649,437,1212,845,4320,324,3996,2341,172,1534,202,71
2014-2018 5-year estimates,17031150700,1651,603,1048,1202,4197,751,3446,1916,64,1933,230,54
2006-2010 5-year estimates,17031150600,1543,404,1139,810,3535,407,3128,2188,15,1170,115,47
2014-2018 5-year estimates,17031150600,1583,470,1113,1047,4246,425,3821,1942,85,1794,353,72
2006-2010 5-year estimates,17031150502,1645,586,1059,981,4997,1189,3808,2306,16,1988,475,212
2014-2018 5-year estimates,17031150502,1653,561,1092,1115,4378,731,3647,2580,70,1360,357,11
2006-2010 5-year estimates,17031150501,1452,385,1067,1114,4257,230,4027,3225,0,811,221,0
2014-2018 5-year estimates,17031150501,1503,396,1107,1103,3957,257,3700,2549,113,994,162,139
2006-2010 5-year estimates,17031150402,1443,544,899,941,3715,554,3161,2359,79,1062,174,41
2014-2018 5-year estimates,17031150402,1487,390,1097,1095,3599,169,3430,2511,53,877,136,22
2006-2010 5-year estimates,17031150401,1981,650,1331,944,4531,621,3910,3406,0,824,209,92
2014-2018 5-year estimates,17031150401,1989,853,1136,1070,5228,486,4742,3141,89,1559,177,262
2006-2010 5-year estimates,17031150300,3160,1368,1792,1009,6002,768,5234,4555,0,1093,183,171
2014-2018 5-year estimates,17031150300,3181,1318,1863,1002,7859,637,7222,4502,201,2490,240,426
2006-2010 5-year estimates,17031150200,3348,2009,1339,845,7849,1939,5910,4151,620,2557,298,223
2014-2018 5-year estimates,17031150200,3436,1411,2025,955,7747,1007,6740,4527,53,2394,554,219
2006-2010 5-year estimates,17031140800,2890,1480,1410,866,7657,1018,6639,3259,92,3036,1093,177
2014-2018 5-year estimates,17031140800,2903,1379,1524,1118,6454,955,5499,2919,333,2270,742,190
2006-2010 5-year estimates,17031140702,2147,1379,768,860,5745,1586,4159,1380,255,3650,394,66
2014-2018 5-year estimates,17031140702,2223,1492,731,990,6162,1220,4942,1574,191,3922,300,175
2006-2010 5-year estimates,17031140701,1000,638,362,830,2262,319,1943,663,37,1156,393,13
2014-2018 5-year estimates,17031140701,1157,809,348,1171,2920,394,2526,698,161,1364,549,148
2006-2010 5-year estimates,17031140602,1881,1302,579,940,5497,1666,3831,1083,225,3456,682,51
2014-2018 5-year estimates,17031140602,1835,1068,767,1062,4822,1177,3645,1000,303,2828,566,125
2006-2010 5-year estimates,17031140601,935,502,433,894,3023,420,2603,690,165,1816,283,69
2014-2018 5-year estimates,17031140601,966,557,409,992,2927,392,2535,649,179,1429,626,44
2006-2010 5-year estimates,17031140500,1371,820,551,803,4060,426,3634,1406,105,2333,103,113
2014-2018 5-year estimates,17031140500,1383,665,718,1092,4264,546,3718,1319,182,1941,707,115
2006-2010 5-year estimates,17031140400,2352,1058,1294,921,6647,1329,5318,3059,47,1916,1283,342
2014-2018 5-year estimates,17031140400,2401,717,1684,902,6011,373,5638,2937,25,1757,1088,204
2006-2010 5-year estimates,17031140302,1549,858,691,808,4459,762,3697,654,403,2468,893,41
2014-2018 5-year estimates,17031140302,1411,648,763,1039,4127,532,3595,1393,206,1599,556,373
2006-2010 5-year estimates,17031140301,932,520,412,913,2749,495,2254,360,108,1666,603,12
2014-2018 5-year estimates,17031140301,929,586,343,1096,2700,670,2030,358,40,1638,651,13
2006-2010 5-year estimates,17031140200,1926,1347,579,806,5863,1360,4503,972,188,3876,717,110
2014-2018 5-year estimates,17031140200,1966,1534,432,1041,6429,1684,4745,2102,386,2781,1074,86
2006-2010 5-year estimates,17031140100,1260,857,403,865,3714,754,2960,885,269,2055,445,60
2014-2018 5-year estimates,17031140100,1273,896,377,1148,3527,1062,2465,1178,496,1457,344,52
2006-2010 5-year estimates,17031130300,1952,917,1035,931,5341,491,4850,2581,58,1044,1574,84
2014-2018 5-year estimates,17031130300,1953,1008,945,1186,5482,1069,4413,2490,249,1153,1384,206
2006-2010 5-year estimates,17031130200,718,129,589,878,1465,56,1409,1140,57,136,85,47
2014-2018 5-year estimates,17031130200,671,156,515,960,1547,80,1467,946,30,273,246,52
2006-2010 5-year estimates,17031130100,1910,651,1259,375,4883,474,4409,2876,169,495,1285,58
2014-2018 5-year estimates,17031130100,2026,983,1043,392,5228,685,4543,3134,164,338,1502,90
2006-2010 5-year estimates,17031120400,1380,359,1021,1001,3720,432,3288,2003,28,1248,409,32
2014-2018 5-year estimates,17031120400,1327,272,1055,1289,3749,240,3509,1918,15,1075,647,94
2006-2010 5-year estimates,17031120300,2460,324,2136,961,6427,456,5971,4364,163,704,1158,38
2014-2018 5-year estimates,17031120300,2519,129,2390,1184,6516,274,6242,4488,49,771,1080,128
2006-2010 5-year estimates,17031120200,1708,204,1504,828,4228,123,4105,3400,29,262,469,68
2014-2018 5-year estimates,17031120200,1786,300,1486,2031,4725,274,4451,3289,144,668,507,117
2006-2010 5-year estimates,17031120100,1559,91,1468,1103,4458,76,4382,3677,119,463,138,61
2014-2018 5-year estimates,17031120100,1607,90,1517,1806,4102,103,3999,3572,7,355,98,70
2006-2010 5-year estimates,17031110502,1551,415,1136,824,3318,90,3228,2443,0,718,147,10
2014-2018 5-year estimates,17031110502,1662,832,830,1174,3612,347,3265,2071,132,921,306,182
2006-2010 5-year estimates,17031110501,1890,583,1307,889,5503,77,5426,3187,143,1482,691,0
2014-2018 5-year estimates,17031110501,1910,457,1453,1127,5390,280,5110,3142,25,1538,668,17
2006-2010 5-year estimates,17031110400,1994,801,1193,1010,4785,330,4455,3179,15,1275,277,39
2014-2018 5-year estimates,17031110400,2013,802,1211,1209,4467,366,4101,2759,21,1178,385,124
2006-2010 5-year estimates,17031110300,2063,146,1917,742,5158,186,4972,3647,0,938,519,54
2014-2018 5-year estimates,17031110300,2087,387,1700,992,5720,755,4965,3683,0,1420,473,144
2006-2010 5-year estimates,17031110200,1239,447,792,871,2871,411,2460,2341,0,316,155,59
2014-2018 5-year estimates,17031110200,1276,593,683,1071,3433,309,3124,1948,74,671,612,128
2006-2010 5-year estimates,17031110100,2211,734,1477,954,5075,284,4791,3453,116,1017,318,171
2014-2018 5-year estimates,17031110100,2333,802,1531,1071,5367,649,4718,3556,55,1182,450,124
2006-2010 5-year estimates,17031100700,1909,195,1714,893,4486,336,4150,3698,0,515,252,21
2014-2018 5-year estimates,17031100700,1965,216,1749,1445,4700,188,4512,3749,4,722,175,50
2006-2010 5-year estimates,17031100600,1921,436,1485,1030,4503,392,4111,3467,0,583,404,49
2014-2018 5-year estimates,17031100600,1987,426,1561,1106,4789,249,4540,3378,53,983,330,45
2006-2010 5-year estimates,17031100500,2320,312,2008,1545,5998,360,5638,4823,0,921,229,25
2014-2018 5-year estimates,17031100500,2361,313,2048,1039,5696,336,5360,4681,16,595,144,260
2006-2010 5-year estimates,17031100400,1237,67,1170,1131,3188,290,2898,2697,0,344,147,0
2014-2018 5-year estimates,17031100400,1275,75,1200,1650,3364,178,3186,2712,1,470,100,81
2006-2010 5-year estimates,17031100300,2669,621,2048,1072,6407,301,6106,5781,56,391,179,0
2014-2018 5-year estimates,17031100300,2907,968,1939,1348,6186,247,5939,4957,43,629,317,240
2006-2010 5-year estimates,17031100200,2979,783,2196,929,7390,318,7072,5696,93,1397,204,0
2014-2018 5-year estimates,17031100200,3000,764,2236,1082,6872,660,6212,5664,163,759,126,160
2006-2010 5-year estimates,17031100100,2375,1046,1329,1038,5589,201,5388,4089,55,1119,253,73
2014-2018 5-year estimates,17031100100,2388,768,1620,1239,5563,401,5162,4504,1,894,151,13
2006-2010 5-year estimates,17031090300,575,40,535,1315,1505,60,1445,1470,0,27,8,0
2014-2018 5-year estimates,17031090300,543,95,448,1257,1378,47,1331,1267,0,57,22,32
2006-2010 5-year estimates,17031090200,2980,725,2255,980,6347,305,6042,5768,0,287,198,94
2014-2018 5-year estimates,17031090200,2940,691,2249,1292,6838,144,6694,5788,194,661,99,96
2006-2010 5-year estimates,17031090100,1426,159,1267,936,3275,124,3151,2921,0,284,56,14
2014-2018 5-year estimates,17031090100,1471,248,1223,931,3508,137,3371,2701,29,450,167,161
2006-2010 5-year estimates,17031081900,823,461,362,1536,1388,457,931,448,805,79,56,0
2014-2018 5-year estimates,17031081900,954,220,734,668,923,209,714,445,377,16,73,12
2006-2010 5-year estimates,17031081800,4333,1527,2806,1798,6041,217,5824,4746,167,153,753,222
2014-2018 5-year estimates,17031081800,6514,2882,3632,2344,9919,258,9661,8089,251,444,942,193
2006-2010 5-year estimates,17031081700,2467,1385,1082,1445,2720,207,2513,1710,155,486,260,109
2014-2018 5-year estimates,17031081700,2947,1919,1028,2028,3831,276,3555,2672,172,233,593,161
2006-2010 5-year estimates,17031081600,2932,1775,1157,1695,3226,487,2739,2391,30,208,408,189
2014-2018 5-year estimates,17031081600,3128,1897,1231,2174,4000,320,3680,2765,204,177,680,174
2006-2010 5-year estimates,17031081500,3570,1635,1935,1697,3887,470,3417,3143,84,133,527,0
2014-2018 5-year estimates,17031081500,4216,1899,2317,2046,4585,445,4140,2998,127,403,971,86
2006-2010 5-year estimates,17031081403,4568,2372,2196,1487,5158,438,4720,3386,148,306,1144,174
2014-2018 5-year estimates,17031081403,6317,4049,2268,2133,8046,869,7177,5437,242,379,1704,284
2006-2010 5-year estimates,17031081402,3293,1425,1868,1478,3776,332,3444,2907,71,212,507,79
2014-2018 5-year estimates,17031081402,4189,2157,2032,2201,5325,591,4734,3417,212,207,1285,204
2006-2010 5-year estimates,17031081401,1834,699,1135,1186,2381,271,2110,1797,275,46,205,58
2014-2018 5-year estimates,17031081401,1804,776,1028,1871,2342,288,2054,1748,34,82,280,198
2006-2010 5-year estimates,17031081300,4395,1158,3237,1188,5229,340,4889,4443,202,137,447,0
2014-2018 5-year estimates,17031081300,4330,1334,2996,1563,5313,653,4660,4149,125,267,716,56
2006-2010 5-year estimates,17031081202,2325,500,1825,1201,3005,282,2723,2642,0,191,93,79
2014-2018 5-year estimates,17031081202,2233,447,1786,1587,2951,124,2827,2469,63,116,231,72
2006-2010 5-year estimates,17031081201,3005,1159,1846,1326,3804,453,3351,3000,98,137,479,90
2014-2018 5-year estimates,17031081201,3774,1733,2041,1823,4500,302,4198,3483,109,277,590,41
2006-2010 5-year estimates,17031081100,3020,2062,958,1201,3255,661,2594,2458,423,124,207,43
2014-2018 5-year estimates,17031081100,3187,2397,790,1699,4092,663,3429,2605,311,699,347,130
2006-2010 5-year estimates,17031081000,5163,3956,1207,954,7487,1872,5615,5575,838,327,690,57
2014-2018 5-year estimates,17031081000,5422,4290,1132,1210,7439,1480,5959,4741,1040,601,982,75
2006-2010 5-year estimates,17031080400,2067,1458,609,375,4441,1936,2505,1333,2652,279,158,19
2014-2018 5-year estimates,17031080400,2002,1363,639,590,4142,953,3189,1297,2468,168,76,133
2006-2010 5-year estimates,17031080300,2745,1137,1608,1379,4181,360,3821,3266,375,236,251,53
2014-2018 5-year estimates,17031080300,2935,1272,1663,2042,4770,248,4522,3644,185,383,489,69
2006-2010 5-year estimates,17031080202,2636,804,1832,1216,3040,164,2876,2522,194,171,153,0
2014-2018 5-year estimates,17031080202,2747,1112,1635,1409,3302,314,2988,2874,114,162,152,0
2006-2010 5-year estimates,17031080201,2800,881,1919,1171,3506,168,3338,3018,56,115,238,79
2014-2018 5-year estimates,17031080201,2577,984,1593,1582,3141,38,3103,2526,196,61,254,104
2006-2010 5-year estimates,17031080100,4653,1745,2908,1362,5732,413,5319,5168,119,92,320,33
2014-2018 5-year estimates,17031080100,4676,2079,2597,1737,6795,550,6245,5893,177,144,382,199
2006-2010 5-year estimates,17031071800,1246,414,832,1104,2679,201,2478,2227,248,65,113,26
2014-2018 5-year estimates,17031071800,1120,449,671,1753,2741,126,2615,1997,267,163,258,56
2006-2010 5-year estimates,17031071700,807,264,543,1538,1689,62,1627,1261,124,141,163,0
2014-2018 5-year estimates,17031071700,708,268,440,2086,1729,41,1688,1242,179,70,166,72
2006-2010 5-year estimates,17031071600,884,339,545,1703,2032,118,1914,1769,62,79,94,28
2014-2018 5-year estimates,17031071600,828,275,553,1582,1832,161,1671,1342,189,96,126,79
2006-2010 5-year estimates,17031071500,4378,2306,2072,1279,5330,448,4882,4413,479,288,134,16
2014-2018 5-year estimates,17031071500,4179,2648,1531,1670,6065,285,5780,5117,113,197,454,184
2006-2010 5-year estimates,17031071400,3157,1893,1264,1140,4670,546,4124,3871,150,304,219,126
2014-2018 5-year estimates,17031071400,3059,1730,1329,1550,4745,778,3967,3609,270,324,278,264
2006-2010 5-year estimates,17031071300,2164,953,1211,1121,3904,418,3486,3441,127,125,211,0
2014-2018 5-year estimates,17031071300,2003,954,1049,1497,3982,350,3632,3282,50,177,438,35
2006-2010 5-year estimates,17031071200,1164,571,593,1501,1961,214,1747,1588,125,95,143,10
2014-2018 5-year estimates,17031071200,1009,463,546,1628,2024,180,1844,1489,128,166,180,61
2006-2010 5-year estimates,17031071100,1348,675,673,1611,2859,506,2353,2536,63,136,88,36
2014-2018 5-year estimates,17031071100,1109,584,525,1789,3180,321,2859,2264,88,236,412,180
2006-2010 5-year estimates,17031071000,1237,605,632,1864,5306,1098,4208,4120,78,590,347,171
2014-2018 5-year estimates,17031071000,1116,537,579,2055,4604,437,4167,3628,252,263,335,126
2006-2010 5-year estimates,17031070700,1844,592,1252,944,2809,486,2323,1917,241,301,282,68
2014-2018 5-year estimates,17031070700,2066,904,1162,1659,4272,713,3559,2826,450,527,384,85
2006-2010 5-year estimates,17031070600,1401,387,1014,1793,2791,159,2632,2512,9,180,70,20
2014-2018 5-year estimates,17031070600,1424,395,1029,1863,3257,153,3104,2734,12,303,198,10
2006-2010 5-year estimates,17031070500,1381,654,727,1700,3244,191,3053,2873,105,125,132,9
2014-2018 5-year estimates,17031070500,1384,511,873,1780,3421,161,3260,2816,233,114,196,62
2006-2010 5-year estimates,17031070400,1766,1046,720,1016,3184,468,2716,2531,174,252,125,102
2014-2018 5-year estimates,17031070400,1651,899,752,1209,3237,330,2907,2546,218,138,280,55
2006-2010 5-year estimates,17031070300,1815,907,908,1431,3269,530,2739,2677,73,177,286,56
2014-2018 5-year estimates,17031070300,1819,954,865,1858,3575,275,3300,3062,52,157,158,146
2006-2010 5-year estimates,17031070200,2244,1286,958,1057,3610,422,3188,2776,94,34,442,264
2014-2018 5-year estimates,17031070200,2222,1347,875,1509,4283,411,3872,3457,225,240,338,23
2006-2010 5-year estimates,17031070103,1329,1082,247,1038,1740,278,1462,1450,32,93,165,0
2014-2018 5-year estimates,17031070103,1328,1147,181,1366,1621,164,1457,1277,83,86,166,9
2006-2010 5-year estimates,17031070102,1814,1136,678,853,2253,255,1998,1600,148,158,290,57
2014-2018 5-year estimates,17031070102,2066,1399,667,1332,2920,193,2727,2304,95,278,163,80
2006-2010 5-year estimates,17031070101,3047,1590,1457,981,3545,440,3105,2917,143,78,359,48
2014-2018 5-year estimates,17031070101,2906,1632,1274,1368,3878,617,3261,3177,44,163,241,253
2006-2010 5-year estimates,17031063400,1269,879,390,1136,2018,414,1604,1592,159,145,89,33
2014-2018 5-year estimates,17031063400,1354,896,458,1453,2318,132,2186,1893,62,111,177,75
2006-2010 5-year estimates,17031063303,1332,712,620,1234,1496,115,1381,1313,13,0,170,0
2014-2018 5-year estimates,17031063303,1076,592,484,2553,1223,72,1151,1043,3,59,111,7
2006-2010 5-year estimates,17031063302,3221,2007,1214,1104,4067,305,3762,3509,46,140,354,18
2014-2018 5-year estimates,17031063302,3058,2002,1056,1438,3781,276,3505,2955,120,290,353,63
2006-2010 5-year estimates,17031063301,1953,1535,418,965,2475,448,2027,1639,292,148,376,20
2014-2018 5-year estimates,17031063301,1916,1549,367,1236,2768,424,2344,2067,214,186,133,168
2006-2010 5-year estimates,17031063200,4598,3118,1480,1023,6572,618,5954,4955,322,634,499,162
2014-2018 5-year estimates,17031063200,4471,2801,1670,1374,6897,579,6318,5878,79,468,394,78
2006-2010 5-year estimates,17031063100,1442,1105,337,1026,2112,501,1611,1580,121,187,198,26
2014-2018 5-year estimates,17031063100,1315,875,440,1430,2310,185,2125,1833,21,162,123,171
2006-2010 5-year estimates,17031063000,1924,1429,495,1108,3588,893,2695,3072,174,149,118,75
2014-2018 5-year estimates,17031063000,1887,1134,753,1327,3448,279,3169,2462,169,235,385,197
2006-2010 5-year estimates,17031062900,2118,1122,996,1391,4307,569,3738,3793,12,375,74,53
2014-2018 5-year estimates,17031062900,1997,1120,877,1550,3818,283,3535,3313,169,111,138,87
2006-2010 5-year estimates,17031062800,1810,881,929,1504,3729,291,3438,2842,229,428,194,36
2014-2018 5-year estimates,17031062800,1618,864,754,2018,3625,185,3440,2962,53,251,244,115
2006-2010 5-year estimates,17031062700,1365,728,637,1364,2430,197,2233,2141,9,167,67,46
2014-2018 5-year estimates,17031062700,1273,559,714,1786,2885,124,2761,2611,8,147,55,64
2006-2010 5-year estimates,17031062600,952,346,606,1311,2064,105,1959,1811,8,140,91,14
2014-2018 5-year estimates,17031062600,998,352,646,1584,2370,38,2332,1764,31,171,282,122
2006-2010 5-year estimates,17031062500,750,309,441,1335,1579,193,1386,1294,51,99,102,33
2014-2018 5-year estimates,17031062500,787,362,425,1983,1575,205,1370,1252,41,134,133,15
2006-2010 5-year estimates,17031062400,776,407,369,1379,1770,94,1676,1474,3,198,91,4
2014-2018 5-year estimates,17031062400,800,325,475,1846,1576,58,1518,1381,66,39,54,36
2006-2010 5-year estimates,17031062300,819,471,348,1486,1703,167,1536,1573,15,76,39,0
2014-2018 5-year estimates,17031062300,720,321,399,1923,1602,67,1535,1324,28,52,116,82
2006-2010 5-year estimates,17031062200,1544,836,708,1422,3001,210,2791,2461,21,285,135,99
2014-2018 5-year estimates,17031062200,1386,802,584,1659,2719,182,2537,2178,121,309,111,0
2006-2010 5-year estimates,17031062100,1849,1157,692,1302,3072,617,2455,2311,13,305,385,58
2014-2018 5-year estimates,17031062100,2028,1328,700,1630,3772,558,3214,3075,99,315,208,75
2006-2010 5-year estimates,17031062000,1612,1140,472,1176,2599,182,2417,2161,98,197,131,12
2014-2018 5-year estimates,17031062000,1653,1050,603,1394,2981,173,2808,2480,75,154,170,102
2006-2010 5-year estimates,17031061902,2915,2112,803,961,4010,525,3485,3237,188,233,312,40
2014-2018 5-year estimates,17031061902,3172,2140,1032,1336,4653,554,4099,3809,107,139,470,128
2006-2010 5-year estimates,17031061901,2829,1704,1125,945,3701,670,3031,2503,272,501,274,151
2014-2018 5-year estimates,17031061901,2409,1622,787,1329,3597,367,3230,2610,47,289,590,61
2006-2010 5-year estimates,17031061800,750,609,141,928,898,89,809,752,9,94,43,0
2014-2018 5-year estimates,17031061800,735,583,152,1365,1340,168,1172,919,56,142,126,97
2006-2010 5-year estimates,17031061500,921,629,292,1219,1900,44,1856,1670,0,143,35,52
2014-2018 5-year estimates,17031061500,887,534,353,1773,1888,125,1763,1532,34,175,50,97
2006-2010 5-year estimates,17031061200,975,556,419,1607,2077,170,1907,1760,19,63,135,100
2014-2018 5-year estimates,17031061200,923,535,388,1781,1961,161,1800,1628,26,159,114,34
2006-2010 5-year estimates,17031061100,719,474,245,1647,1232,152,1080,1180,0,21,31,0
2014-2018 5-year estimates,17031061100,724,389,335,1807,1379,92,1287,1214,42,40,77,6
2006-2010 5-year estimates,17031061000,943,529,414,1103,1712,212,1500,1260,31,189,147,85
2014-2018 5-year estimates,17031061000,1149,788,361,1940,2208,318,1890,1770,36,243,117,42
2006-2010 5-year estimates,17031060900,5158,2809,2349,959,6509,449,6060,4353,653,689,663,151
2014-2018 5-year estimates,17031060900,5151,2908,2243,1274,7114,633,6481,4846,564,1162,319,223
2006-2010 5-year estimates,17031060800,3494,1383,2111,1130,4681,445,4236,3658,140,333,525,25
2014-2018 5-year estimates,17031060800,3490,1727,1763,1625,5048,247,4801,3735,182,344,538,249
2006-2010 5-year estimates,17031060500,815,611,204,745,1169,201,968,1032,14,57,58,8
2014-2018 5-year estimates,17031060500,804,609,195,429,1295,293,1002,837,73,228,136,21
2006-2010 5-year estimates,17031060400,1798,889,909,1256,4131,235,3896,3445,0,508,140,38
2014-2018 5-year estimates,17031060400,1660,896,764,1451,3779,404,3375,3065,29,363,157,165
2006-2010 5-year estimates,17031060300,1464,617,847,1330,3091,99,2992,2841,15,143,92,0
2014-2018 5-year estimates,17031060300,1371,694,677,1474,3214,35,3179,2553,51,314,223,73
2006-2010 5-year estimates,17031060200,1177,845,332,996,2133,282,1851,1384,28,535,186,0
2014-2018 5-year estimates,17031060200,1184,869,315,1238,2324,356,1968,1646,33,435,141,69
2006-2010 5-year estimates,17031060100,1390,639,751,1164,2894,171,2723,2141,62,581,63,47
2014-2018 5-year estimates,17031060100,1321,684,637,1461,2852,183,2669,2204,131,304,91,122
2006-2010 5-year estimates,17031051400,1452,530,922,960,2465,256,2209,1468,442,380,109,66
2014-2018 5-year estimates,17031051400,1387,283,1104,1686,1796,142,1654,1369,68,143,121,95
2006-2010 5-year estimates,17031051300,1264,331,933,1159,2924,123,2801,2487,0,283,117,37
2014-2018 5-year estimates,17031051300,1190,271,919,1960,2826,68,2758,2348,87,185,114,92
2006-2010 5-year estimates,17031051200,803,396,407,1314,1870,252,1618,1572,26,165,88,19
2014-2018 5-year estimates,17031051200,652,370,282,1686,1594,73,1521,1258,101,84,57,94
2006-2010 5-year estimates,17031051100,773,450,323,1188,1687,78,1609,1309,135,160,38,45
2014-2018 5-year estimates,17031051100,716,287,429,1427,1654,55,1599,1305,23,180,43,103
2006-2010 5-year estimates,17031051000,786,386,400,1302,1382,57,1325,1023,0,158,183,18
2014-2018 5-year estimates,17031051000,788,326,462,1715,1718,93,1625,1064,36,463,99,56
2006-2010 5-year estimates,17031050900,742,373,369,974,1470,66,1404,1254,0,108,94,14
2014-2018 5-year estimates,17031050900,667,316,351,1626,1302,62,1240,938,12,184,106,62
2006-2010 5-year estimates,17031050800,637,290,347,1398,1413,185,1228,1007,0,312,57,37
2014-2018 5-year estimates,17031050800,633,349,284,1525,1457,64,1393,1192,23,181,38,23
2006-2010 5-year estimates,17031050700,721,264,457,1108,1739,49,1690,1350,97,208,0,84
2014-2018 5-year estimates,17031050700,716,217,499,1801,1610,56,1554,1488,4,51,37,30
2006-2010 5-year estimates,17031050600,1101,504,597,1332,1926,144,1782,1679,11,121,84,31
2014-2018 5-year estimates,17031050600,1192,555,637,1730,2177,176,2001,1930,3,112,93,39
2006-2010 5-year estimates,17031050500,2352,1023,1329,1180,5242,147,5095,4399,12,398,102,331
2014-2018 5-year estimates,17031050500,2370,933,1437,1705,6069,182,5887,5066,35,458,173,337
2006-2010 5-year estimates,17031050300,1191,511,680,1031,2499,215,2284,2125,0,195,91,88
2014-2018 5-year estimates,17031050300,1150,624,526,1375,2723,264,2459,1725,0,654,307,37
2006-2010 5-year estimates,17031050200,2534,1159,1375,944,4542,527,4015,3046,48,1007,399,42
2014-2018 5-year estimates,17031050200,2425,814,1611,1281,5431,179,5252,4449,64,429,199,290
2006-2010 5-year estimates,17031050100,1271,781,490,1155,2256,124,2132,1934,59,88,164,11
2014-2018 5-year estimates,17031050100,1261,730,531,1568,2731,134,2597,2039,74,242,200,176
2006-2010 5-year estimates,17031040900,1105,708,397,855,1859,145,1714,1396,9,319,61,74
2014-2018 5-year estimates,17031040900,1147,670,477,1138,1842,155,1687,1581,39,100,51,71
2006-2010 5-year estimates,17031040800,807,429,378,1059,1638,95,1543,1196,46,229,93,74
2014-2018 5-year estimates,17031040800,837,472,365,1396,1829,108,1721,1276,65,254,95,139
2006-2010 5-year estimates,17031040700,1712,1033,679,1018,3218,492,2726,2321,97,513,207,80
2014-2018 5-year estimates,17031040700,1694,1013,681,1349,3440,237,3203,2487,84,535,94,240
2006-2010 5-year estimates,17031040600,1331,845,486,940,2683,193,2490,1691,34,746,128,84
2014-2018 5-year estimates,17031040600,1303,821,482,1369,2514,96,2418,2036,65,300,32,81
2006-2010 5-year estimates,17031040402,2562,1519,1043,920,4787,531,4256,3342,195,881,143,226
2014-2018 5-year estimates,17031040402,2678,1739,939,1235,5269,342,4927,3891,53,834,301,190
2006-2010 5-year estimates,17031040401,1529,560,969,1007,2760,284,2476,1835,89,480,217,139
2014-2018 5-year estimates,17031040401,1450,593,857,1389,3347,124,3223,2121,259,699,214,54
2006-2010 5-year estimates,17031040300,1160,387,773,973,2598,153,2445,1220,232,313,803,30
2014-2018 5-year estimates,17031040300,1133,353,780,1347,2925,41,2884,1557,118,343,734,173
2006-2010 5-year estimates,17031040202,3128,1854,1274,903,6723,975,5748,3392,670,738,1910,13
2014-2018 5-year estimates,17031040202,3224,2212,1012,1146,7265,1344,5921,3294,411,1715,1358,487
2006-2010 5-year estimates,17031040201,2948,1772,1176,957,5809,1069,4740,3685,135,1069,704,216
2014-2018 5-year estimates,17031040201,3147,1923,1224,1321,6891,558,6333,4016,174,1813,595,293
2006-2010 5-year estimates,17031040100,1918,923,995,948,4140,356,3784,2654,195,780,326,185
2014-2018 5-year estimates,17031040100,1798,940,858,1226,3879,442,3437,2677,202,713,179,108
2006-2010 5-year estimates,17031032100,4636,3370,1266,830,7066,1618,5448,4374,1006,1143,493,50
2014-2018 5-year estimates,17031032100,4450,3167,1283,1124,6837,1620,5217,4554,251,1569,227,236
2006-2010 5-year estimates,17031031900,1339,954,385,928,2299,347,1952,1488,224,374,181,32
2014-2018 5-year estimates,17031031900,1329,854,475,1161,2566,293,2273,1837,177,302,123,127
2006-2010 5-year estimates,17031031800,1014,589,425,737,1816,309,1507,1417,27,221,138,13
2014-2018 5-year estimates,17031031800,1021,569,452,1123,1857,132,1725,1439,48,204,133,33
2006-2010 5-year estimates,17031031700,4028,2730,1298,651,6928,1822,5106,3823,1329,1216,547,13
2014-2018 5-year estimates,17031031700,3891,2497,1394,944,6691,1606,5085,3728,1473,676,386,428
2006-2010 5-year estimates,17031031502,2485,2113,372,630,5086,1744,3342,1533,2211,895,337,110
2014-2018 5-year estimates,17031031502,2525,2227,298,786,4651,1502,3149,1527,1867,803,330,124
2006-2010 5-year estimates,17031031501,2102,1768,334,569,4601,2259,2342,1296,1401,723,1123,58
2014-2018 5-year estimates,17031031501,2030,1639,391,631,4587,2151,2436,1533,1439,593,847,175
2006-2010 5-year estimates,17031031400,3375,1137,2238,1051,4949,495,4454,3750,350,362,407,80
2014-2018 5-year estimates,17031031400,3555,1540,2015,1191,4853,514,4339,3159,479,321,704,190
2006-2010 5-year estimates,17031031300,3976,2443,1533,706,6660,1798,4862,3020,1245,575,1603,217
2014-2018 5-year estimates,17031031300,4402,2886,1516,956,7604,1680,5924,3678,1555,834,1457,80
2006-2010 5-year estimates,17031031200,3257,2474,783,493,5967,2590,3377,1848,1767,804,1164,384
2014-2018 5-year estimates,17031031200,3092,2304,788,782,5937,1597,4340,2571,1204,1378,605,179
2006-2010 5-year estimates,17031031100,2437,1752,685,928,4502,437,4065,2312,109,1002,958,121
2014-2018 5-year estimates,17031031100,2426,1830,596,1228,5059,622,4437,3302,102,1052,416,187
2006-2010 5-year estimates,17031031000,2080,1297,783,928,3422,527,2895,2120,133,977,132,60
2014-2018 5-year estimates,17031031000,2104,1271,833,1241,4089,278,3811,2727,190,743,275,154
2006-2010 5-year estimates,17031030900,1593,792,801,1046,3014,307,2707,2006,123,495,288,102
2014-2018 5-year estimates,17031030900,1560,809,751,1320,3061,288,2773,1912,363,354,340,92
2006-2010 5-year estimates,17031030800,2331,1330,1001,1115,4366,589,3777,3407,15,383,504,57
2014-2018 5-year estimates,17031030800,2149,1154,995,1388,4392,391,4001,3147,169,612,398,66
2006-2010 5-year estimates,17031030706,2584,1667,917,882,3273,481,2792,1832,499,383,536,23
2014-2018 5-year estimates,17031030706,2237,1584,653,1005,2928,389,2539,1626,522,211,539,30
2006-2010 5-year estimates,17031030703,1858,1187,671,588,2671,542,2129,1704,508,164,261,34
2014-2018 5-year estimates,17031030703,1985,1496,489,879,2909,730,2179,1707,548,376,145,133
2006-2010 5-year estimates,17031030702,1173,309,864,934,1669,37,1632,1145,0,101,423,0
2014-2018 5-year estimates,17031030702,1647,744,903,1286,2252,295,1957,1220,75,75,830,52
2006-2010 5-year estimates,17031030701,969,750,219,664,2065,667,1398,1049,551,162,281,22
2014-2018 5-year estimates,17031030701,980,755,225,871,1712,450,1262,752,446,197,273,44
2006-2010 5-year estimates,17031030604,2212,1575,637,830,3091,569,2522,1409,804,77,715,86
2014-2018 5-year estimates,17031030604,2415,1743,672,1029,3344,816,2528,1426,768,200,825,125
2006-2010 5-year estimates,17031030603,1588,1362,226,712,2053,238,1815,909,808,145,174,17
2014-2018 5-year estimates,17031030603,1581,1416,165,848,2258,540,1718,845,650,383,290,90
2006-2010 5-year estimates,17031030601,2376,1438,938,738,3464,824,2640,1603,784,404,532,141
2014-2018 5-year estimates,17031030601,2158,1447,711,944,3956,696,3260,1892,699,715,615,35
2006-2010 5-year estimates,17031030500,3146,1690,1456,982,6837,1026,5811,3630,449,1922,608,228
2014-2018 5-year estimates,17031030500,3312,1694,1618,1363,6428,354,6074,3883,350,1473,457,265
2006-2010 5-year estimates,17031030400,1464,861,603,826,2708,217,2491,1515,277,616,209,91
2014-2018 5-year estimates,17031030400,1417,787,630,909,2582,411,2171,1352,95,832,167,136
2006-2010 5-year estimates,17031030300,1489,1055,434,810,2776,555,2221,1181,162,1063,302,68
2014-2018 5-year estimates,17031030300,1556,1070,486,980,3464,831,2633,1216,458,1205,426,159
2006-2010 5-year estimates,17031030200,2710,1421,1289,1105,5797,452,5345,3939,632,664,346,216
2014-2018 5-year estimates,17031030200,2742,1420,1322,1161,5444,778,4666,4197,366,629,138,114
2006-2010 5-year estimates,17031030104,1334,779,555,923,4204,1324,2880,2391,695,283,504,331
2014-2018 5-year estimates,17031030104,1141,713,428,1009,3569,996,2573,2261,303,299,609,97
2006-2010 5-year estimates,17031030103,1192,841,351,709,1632,707,925,758,420,134,212,108
2014-2018 5-year estimates,17031030103,1183,883,300,1019,2252,374,1878,1068,402,343,332,107
2006-2010 5-year estimates,17031030102,2042,1156,886,725,3190,775,2415,1540,733,311,470,136
2014-2018 5-year estimates,17031030102,2112,1195,917,1005,2703,438,2265,1420,433,250,364,236
2006-2010 5-year estimates,17031030101,2542,1456,1086,766,3795,827,2968,1521,861,796,553,64
2014-2018 5-year estimates,17031030101,2464,1569,895,976,3768,554,3214,1455,1042,606,573,92
2006-2010 5-year estimates,17031020902,1668,650,1018,813,4473,751,3722,1957,650,764,1071,31
2014-2018 5-year estimates,17031020902,1746,814,932,979,4680,1250,3430,1932,682,916,1070,80
2006-2010 5-year estimates,17031020901,2295,1282,1013,947,6380,1193,5187,1227,785,2392,1711,265
2014-2018 5-year estimates,17031020901,2195,1584,611,1202,5966,1724,4242,1317,1366,1463,1455,365
2006-2010 5-year estimates,17031020802,2455,1336,1119,928,6746,1167,5579,1966,793,1734,1923,330
2014-2018 5-year estimates,17031020802,2508,1620,888,1112,7952,2083,5869,2191,1111,1272,2692,686
2006-2010 5-year estimates,17031020801,2158,1091,1067,866,5841,1133,4708,2452,187,2000,1157,45
2014-2018 5-year estimates,17031020801,2320,1356,964,1142,6112,1008,5104,2390,326,1411,1792,193
2006-2010 5-year estimates,17031020702,2545,1369,1176,939,7285,976,6309,3266,345,875,2751,48
2014-2018 5-year estimates,17031020702,2574,1752,822,1070,7674,1696,5978,3424,666,1789,1734,61
2006-2010 5-year estimates,17031020701,654,229,425,1285,1928,472,1456,1030,113,321,427,37
2014-2018 5-year estimates,17031020701,743,260,483,1367,1748,115,1633,1116,92,234,283,23
2006-2010 5-year estimates,17031020602,1516,814,702,955,4407,317,4090,1395,298,1584,1078,52
2014-2018 5-year estimates,17031020602,1573,942,631,1144,4734,1041,3693,1977,535,1067,996,159
2006-2010 5-year estimates,17031020601,2219,1231,988,942,6035,1973,4062,2856,391,1508,1049,231
2014-2018 5-year estimates,17031020601,2172,1162,1010,1134,6131,1490,4641,3521,570,348,1333,359
2006-2010 5-year estimates,17031020500,2293,1319,974,902,5750,1426,4324,1084,813,1788,1651,414
2014-2018 5-year estimates,17031020500,2449,1758,691,1038,6584,1732,4852,1125,837,1664,2340,618
2006-2010 5-year estimates,17031020400,1779,871,908,944,3835,384,3451,2290,373,387,645,140
2014-2018 5-year estimates,17031020400,1834,856,978,1161,4236,758,3478,1777,858,835,631,135
2006-2010 5-year estimates,17031020302,1795,724,1071,1063,4605,576,4029,2957,413,554,480,201
2014-2018 5-year estimates,17031020302,1906,779,1127,1206,5348,1219,4129,2979,850,823,498,198
2006-2010 5-year estimates,17031020301,2141,389,1752,792,4470,487,3983,3529,146,464,290,41
2014-2018 5-year estimates,17031020301,2235,617,1618,867,5472,744,4728,4043,202,451,600,176
2006-2010 5-year estimates,17031020200,2116,384,1732,956,6773,921,5852,3821,1022,385,1480,65
2014-2018 5-year estimates,17031020200,2280,752,1528,997,6739,910,5829,3190,1068,1090,1186,205
2006-2010 5-year estimates,17031020100,1570,787,783,952,3541,825,2716,1327,1021,665,528,0
2014-2018 5-year estimates,17031020100,1737,946,791,1063,3836,545,3291,1218,1157,815,377,269
2006-2010 5-year estimates,17031010702,2258,1689,569,830,5514,1423,4091,1345,1121,2901,75,72
2014-2018 5-year estimates,17031010702,2268,1746,522,1029,5096,1233,3863,1550,1184,1822,397,143
2006-2010 5-year estimates,17031010701,1647,767,880,853,3734,493,3241,1570,542,1427,65,130
2014-2018 5-year estimates,17031010701,1704,867,837,1038,3766,783,2983,1514,719,980,518,35
2006-2010 5-year estimates,17031010600,3299,1954,1345,845,6563,1765,4798,2394,1673,1861,346,289
2014-2018 5-year estimates,17031010600,3301,2528,773,993,6271,1530,4741,3517,1030,1370,162,192
2006-2010 5-year estimates,17031010503,1245,975,270,709,1778,679,1099,1213,287,156,94,28
2014-2018 5-year estimates,17031010503,1258,1003,255,690,1713,822,891,1072,227,106,216,92
2006-2010 5-year estimates,17031010502,1957,1476,481,759,3294,1239,2055,1721,578,466,308,221
2014-2018 5-year estimates,17031010502,1796,1368,428,991,2802,841,1961,1443,772,275,234,78
2006-2010 5-year estimates,17031010501,2561,2004,557,740,4138,1270,2868,1564,2048,215,248,63
2014-2018 5-year estimates,17031010501,2652,2313,339,965,4147,858,3289,1891,1368,457,246,185
2006-2010 5-year estimates,17031010400,2375,1488,887,837,4651,846,3805,2749,646,661,427,168
2014-2018 5-year estimates,17031010400,2186,1692,494,1010,5153,984,4169,3435,966,309,327,116
2006-2010 5-year estimates,17031010300,3295,1970,1325,859,6475,1392,5083,3037,1366,1588,391,93
2014-2018 5-year estimates,17031010300,3399,2144,1255,976,6650,1071,5579,3082,2082,1121,150,215
2006-2010 5-year estimates,17031010202,1295,899,396,832,2981,677,2304,969,1087,679,61,185
2014-2018 5-year estimates,17031010202,1256,831,425,973,2852,528,2324,812,765,828,315,132
2006-2010 5-year estimates,17031010201,2973,1761,1212,855,5924,1795,4129,1437,2763,1335,300,89
2014-2018 5-year estimates,17031010201,2984,2024,960,1023,7039,2590,4449,2284,2592,1500,148,515
2006-2010 5-year estimates,17031010100,2670,1987,683,729,5303,1554,3749,1188,2642,649,541,283
2014-2018 5-year estimates,17031010100,2656,2002,654,874,4522,1619,2903,1855,2059,404,28,176
